0.0.1
windows 8	windows8
windows 7	windows7
gamcener	gamecenter
absorbiern	absorbieren
xcapelli	capelli
antwortest:	antwortest
worshington	washington
moronal®	moronal
feragno	ferragni
ausweg.	ausweg
schnöde,	schnöde
juarez®	juarez
phenomtm	phenom
enchantress:	enchantress
gazetelerini	gazeteleri
hammermässiges	hammermäßiges
dennigs	dennings
ether’s	ether's
schönnste	schönsten
radeontm	radeon
ausweg,	ausweg
nacion,	nacion
kardaahian	kardashian
wanderer,	wanderer
smudlers	smulders
dannings	dennings
bowbly	bowlby
fettendem	fettendes
verwoehne	verwöhne
verrueckten	verrückten
d'yayin	dyayin
interpretative	interpretive
frisunren	frisuren
vitalitaet	vitalität
greenen	greene
tequila:	tequila
linden)	linden
punctuation:	punctuation
werdendem	werdendes
stagnottis	stagnettis
moerderischer	mörderischer
jazara	jazeera
moerderische	mörderische
z:battle	battle
soldier:	soldier
wenn’s	wenn's
rentier,	rentier
clancy's:	clancy's
salgado.	salgado
athlontm	athlon
saygım	saygim
5550.bw	5550.b
macunun	macunu
sulemans	suleman
kardasihan	kardashian
breaker:	breaker
morgan’s	morgan's
hutington	huntington
troopers:	troopers
bestienmeisters:	bestienmeisters
dcanlı	dcanli
rundes,	rundes
scramble:	scramble
tsukaima:	tsukaima
d'canlı	d'canli
mccurdy's	mccurdy
tatlisess	tatlises
wünsches	wünsche
unregelmässigem	unregelmäßigem
welshs	welsh's
katdashian	kardashian
ichizoku:	ichizoku
haarfrisureb	haarfrisuren
anne’s	anne's
torgue’s	torgue's
gelegenheit:	gelegenheit
galactica:	galactica
lively's	lively
zweieiiger	zweieiige
turtilla	tortilla
danshi,	danshi
stagnetti’s	stagnetti's
karsashian	kardashian
trixiebelle	trixibelle
ueberstreckt	überstreckt
anaromy	anatomy
abraham:	abraham
internet explorer	internetexplorer
smulder	smulders
denings	dennings
parsana	parsanada
scheide..	scheide
galáxy	galaxy
schönstn	schönsten
duennem	dünnem
grabde	grande
thrines	thrones
lagoon:	lagoon
watsin	watson
piyasada	piyasa
flugausbildung:	flugausbildung
warson	watson
kontakcie	kontakte
stimmuliere	stimuliere
middeleton	middleton
verfuehre	verführe
steroidalen	steroidale
yuezyil	yüzyil
kadeshian	kardashian
theones	thrones
schaelt	schält
kardadhian	kardashian
åkerman	akerman
lincoln:	lincoln
gerührt,	gerührt
chalkes	chalke
cocker's	cocker
absolutions	absolution
beatufull	beautiful
schuttelt	schüttelt
backensale	beckinsale
bureau:	bureau
anistin	aniston
kardashian:	kardashian
kardeshian	kardashian
mccury	mccurdy
walkign	walking
nächste,	nächste
dünnes,	dünnes
dskika	dakika
dakika.	dakika
tatlitugun	tatlitug
bosparanisches	bosparanische
tiempoen	tiempo
kardashiam	kardashian
faeltskog	fältskog
[geheimnisse	geheimnisse
bündchen,	bündchen
perfect:	perfect
shippuudden	shippuuden
soleil:	soleil
zerfallenen	zerfallene
buyer’s	buyer's
corrriere	corriere
juarez:	juarez
throens	thrones
foderation	föderation
́osteria	osteria
redenption	redemption
lwrence	lawrence
schönebergers	schöneberger
couitus	coitus
radeon®	radeon
trainers:	trainers
jutepfad:	jutepfad
kardashion	kardashian
((bontan	(bontan
somerhalder's	somerhalder
ridance	riddance
thrones,	thrones
starter:	starter
error(13)	error(13):
kardashin	kardashian
lawernce	lawrence
flacheren	flachen
915gm/gms,	915gm/gms
glöcken	glöckchen
skurky's	skurkys
zerfallende	zerfallene
sheeran's	sheeran
kaedashian	kardashian
dravin's	dravins
pilcher:	pilcher
lagazetta	gazzetta
(florence	florence
sisters:	sisters
lawrences	lawrence
schuettelt	schüttelt
thicke's	thicke
watsom	watson
späherbericht:	späherbericht
meier’s	meier's
dobrev's	dobrev
zimbio,	zimbio
presniakov	presnyakov
walkind	walking
volksfreund,	volksfreund
[wanderer,	wanderer
hailie's	hailies
diairo	diario
forschungsprojekt:	forschungsprojekt
sherbatsky	scherbatsky
eveing	evening
umutum	umudum
candle's	candles
schattenwort:	schattenwort
davenstet	davenstedt
thrones:	thrones
tiempo.	tiempo
radikalem	radikales
herausforderung:	herausforderung
warrior’s	warrior's
strahowski	strahovski
[zauberformel	zauberformel
handmaids	handmaid's
gurubuna	grubuna
[geringes	geringes
naylin	nailin
bounty:	bounty
karenina,	karenina
corrierre	corriere
pirate’s	pirate's
radcliffes	radcliffe
middleto	middleton
kombat:	kombat
arteton	arterton
eccelstone	ecclestone
helllichten	hellichten
perodico	periodico
hawk’s	hawk's
kadashien	kardashian
johanssons	johansson
überlebensring:	überlebensring
guppy's	guppys
geforcetm	geforce
kutchers	kutcher
surftab®	surftab
gewoehne	gewöhne
kadashian	kardashian
nettlog	netlog
schöneberger,	schöneberger
Ärgere	ärgere
online,kosci	online,kości
mostgrador	mostrador
liedschattenfarbe	lidschattenfarbe
kurzhaat	kurzhaar
dädrische	daedrische
jordão	jordao
direction's	direction
gledau	gledai
maonoramma	manorama
sauthpak	southpark
thromes	thrones
stralande	strålande
andesagte	angesagte
bootfaehig	bootfähig
kleidform	kleider
verreiß	verreiss
aterton	arterton
karadashian	kardashian
shanchai	shanghai
trilogie:	trilogie
welcone	welcome
kardon®	kardon
schicksalsrunen	schicksalsrune
deinik	dainik
ppittsburgh	pittsburgh
walkinf	walking
crawford's	crawford
longorias	longoria
gefaerbte	gefärbte
lwarence	lawrence
drunge	drudge
befridige	befriedige
schönerberger	schöneberger
jitztspielen	jetztspiele
cuckoo’s	cuckoo's
loniest	loneliest
tiempp	tiempo
walkking	walking
nabharat	navbharat
mittleton	middleton
socialite's	socialite
erschlaft	erschlafft
verreis	verreiss
maharatra	maharashtra
willkinson	wilkinson
gewöhn	gewöhne
kardashien	kardashian
middelton	middleton
partenkirchener	partenkirchner
lasniers	lasnier
midlleton	middleton
timberlake:	timberlake
gūncel	guncel
hitori,	hitori
middletone	middleton
kardshian	kardashian
middelten	middleton
getsync()	getsync():
heiligtuemer	heiligtümer
liveable	livable
wordbiggest	worldbiggest
huffinghton	huffington
kardishian	kardashian
vinci’s	vinci's
[stulpen	stulpen
deshanel	deschanel
schòner	schöner
basliklarini	basliklari
geographic's	geographic
gefarbte	gefärbte
lebowski:	lebowski
sideslike	siteslike
atkinson's	atkinson
unreachable:	unreachable
momunment	monument
[schlüssel	schlüssel
erlose	erlöse
fforde:	fforde
galzetta	gazzetta
java/lang/noclassdeffounderror	java/lang/noclassdeffounderror:
auflegt,	auflegt
trouble.	trouble
iltalehti.	iltalehti
octomom:	octomom
wlaking	walking
suleman's	suleman
gemeiselter	gemeißelter
trhones	thrones
krdashian	kardashian
gürsesin	gürses
unverzeihlichen	unverzeihliche
lawrende	lawrence
emblem:	emblem
wächste	wächst
startauswahl.	startauswahl
baolei	baolai
autotrater	autotrader
wilkinson's	wilkinson
lawrence's	lawrence
vliegender	vliegende
ansiston	aniston
hethaway	hathaway
[uralter	uralter
sccorer	soccer
middleton,	middleton
alliance:	alliance
saiyna	saiyan
w4lking	walking
komsomolskaaja	komsomolskaja
bardout	bardot
tiempi	tiempo
showrel	showreel
clancy’s	clancy's
lawrence.	lawrence
bibeer	bieber
naidoos	naidoo
birkin,	birkin
brosnans	brosnan
posietionen	positionen
schweimsteiger	schweinsteiger
paradies:	paradies
kurzhaarfreisur	kurzhaarfrisur
thrones.	thrones
prenzaluer	prenzlauer
(forget	forget
hathawy	hathaway
kampfhaustierzähmer:	kampfhaustierzähmer
blitschen	bleichen
spiele.dejetzt	spielenjetzt
devodant	deviant
belluccie	bellucci
monteith's	monteith
stapenbeck	stappenbeck
vermaechtnis	vermächtnis
ru.ria	russia
roasario	rosario
austin,	houston,
mütter,	mütter
jorado	jordao
schlaeft	schläft
femimin	feminin
weissere	weisse
schösten	schönsten
zllertaler	zillertaler
satilikk	satilik
drughe	drudge
makeloser	makelloser
tomlinson's	tomlinson
vergara's	vergara
reichstes	reichste
actors:	actors
junngle	jungle
aureol®	aureol
ryouran:	ryouran
stuffiger	stufiger
abgesetzt,	abgesetzt
timerblake	timberlake
ealking	walking
haarfrizuren	haarfrisuren
urfalıyım	urfalıyam
rising:	rising
dizioanrio	dizionario
merunes	mehrunes
glockchen	glöckchen
tragst	trägst
hoscheck	hoschek
ratajkowsk	ratajkowski
smoulders	smulders
spaltenbuchstaben	spaltenbuchstabe
knighley	knightley
empire:	empire
obelix:	obelix
schlankere	schlanke
brosnan's	brosnan
france24en	france24
anisten	aniston
thrnes	thrones
dairio	diario
karashian	kardashian
beckensale	beckinsale
citizen:	citizen
renekhton	renekton
weissröckchen	weißröckchen
porn`s	porn’s
kaltenkircher	kaltenkirchener
lautners	lautner
quadro®	quadro
khardashian	kardashian
dateiausf	datenausf
fussstapfen	fußstapfen
yûzyil	yüzyil
pentium™	pentium®
kardashan	kardashian
toedliches	tödliches
gontra	contra
musuems	museums
thickes	thicke
vergera	vergara
heiligtumer	heiligtümer
shippūden	shippuuden
schneeflöcken	schneeflöckchen
millan's	millan
[siegel	siegel
fotzen,	fotzen
store.e	stor.e
aelterem	älteren
superstar:	superstar
gazzetta.	gazzetta
alternative:	alternative
sayjan	saiyan
malhite	malphite
lantern:	lantern
́maw	maw
wiadonosci	wiadomosci
sawatzkis	sawatzki
verworffene	verworfene
mobbefire	mobafire
kurzharrfrisure	kurzhaarfrisur
lawrece	lawrence
gretel:	gretel
raptures	rapture
kardahian	kardashian
^jetzt	jetzt
abdeckendes	deckendes
cumhuruyet	cumhuriyet
cumhutiyet	cumhuriyet
muhtesemm	muhteşem
dyansty	dynasty
kardashian.	kardashian
tillner's	tillners
strike:	strike
zengiz	zengin
kurzhaarfristen	kurzhaarfrisuren
waywards	wayward
irelai	irelia
bokanovsky's	bokanovsky
heathaway	hathaway
penettiere	panettiere
walkimg	walking
sevret	secret
legensd	legends
schûler	schüler
jovowich	jovovich
medisat	mediaset
kardishan	kardashian
incomnia	icomania
kardashian's	kardashian
island:	island
www.imm0welt	www.immowelt
bucheb	buchen
duennere	dünnere
elsässers	elsässer
minachel	michael
instruments:	instruments
tendige	trendige
gemeißelten	gemeißelter
pureli	püreli
izlenilen	izlenen
cachys	cashys
dogg’s	dogg's
schoppernou	schoppernau
errogene	erogene
yufkayla	yufkadan
diemens	diemen's
liveley	lively
immobein	immobilien
renektion	renekton
www.redio	www.radio
1.punischer	punischer
speats	spears
jedsica	jessica
backinsale	beckinsale
deschane	deschanel
(noch)	noch
hewwit	hewitt
orderint	oderint
neckarstad	neckarstadt
haber!	haber
mcurdy	mccurdy
bekinsale	beckinsale
anistion	aniston
buyer's	buyers
shin'ka,	shin'ka
fowards	forwards
nosbush	nosbusch
vorzugen	vorzügen
medikamentösem	medikamentösen
middleton's	middleton
underground's	underground
plegeleichte	pflegeleichte
ferullo's	ferullos
walkung	walking
kurzhaarfruren	kurzhaarfrisuren
noordhollandse	noordhollands
panettier	panettiere
redamption	redemption
verboten!	verboten
sokolovs	sokolov
escspe	escape
a.akamaihd.net/	a.akamaihd.net
returns:	returns
seelen:	seelen
steenkamps	steenkamp
vkantakti	kontakte
midelton	middleton
beckingsale	beckinsale
maharshtra	maharashtra
krzhaarfriesuren	kurzhaarfrisuren
forune	fortune
besorg	besorge
www.immobilienscovt	www.immobilienscout
flacherer	flacher
verdienten	verdiente
clapton's	clapton
deschanell	deschanel
gazzetto	gazzetta
maplphite	malphite
coemrcio	comercio
dragonborne	dragonborn
òroscopo	oroscopo
archam	arkham
dasnya	dasniya
cattral	cattrall
forecat	forecast
heaven’s	heaven's
́creatures	creatures
immobeiin	immobilien
mittelhaar	mittellang
hurt	hurts
leanner	leanna
turkiyeninin	turkiyenin
lovatos	lovato
stinsons	stinson
semetary	sematary
kardashisn	kardashian
strafferen	straffen
hudgends	hudgens
sexistisch,	sexistisch
redemtion	redemption
magazinden	magazinde
waldorfs	waldorf
thaumaturge's	thaumaturges
renektron	renekton
beckinsal	beckinsale
elgends	legends
countings	counting
weisere	weisse
malhpite	malphite
erena.	erena
inconia	iconia
khalifa's	khalifa
zerbrochne	zerbrochene
mentalist,	mentalist
redmption	redemption
clankers	clanker's
mahrashtra	maharashtra
thigns	things
dekika	dakika
letzt.	letzter
tomlinsons	tomlinson
vkntakte.ru	vkontakte.ru
fragezeich	fragezeichen
rundem	rundes
schuerl	schueler
modors	mordors
mendel'sche	mendelsche
delevingnes	delevingne
angocin®	angocin
kardasian	kardashian
maceristan	macaristan
//gorojanin	gorojanin
junlge	jungle
countig	counting
dakikka	dakika
erogenste	erogene
schõner	schöner
vaporup	vaporub
longstockings	longstocking
durchnehmen,	durchnehmen
gebrige	gebirge
jugnle	jungle
coriere	corriere
sexloser	sexlose
c.tscharre	tscharre
calder's	calder
www.jeztzt	www.jetzt
jungkle	jungle
valseuse	valseuses
vkontekte.ru	vkontakte.ru
waldorf's	waldorf
effect2	effect
anzeicher	anzeichen
jennifet	jennifer
qalsin	kalsin
somerhalders	somerhalder
pompeos	pompeo
djazeera	jazeera
anrachy	anarchy
dragons,	dragons
durchgenommen,	durchgenommen
friend’s	friend's
mccurdys	mccurdy
lonliest	loneliest
magazinn	magazin
vergaras	vergara
markieren,	markieren
derviş	dervis
poweshot	powershot
faction:	faction
klitorialer	klitoraler
östrogenfreien	östrogenfreie
farraf	farrah
haarschnmitte	haarschnitte
direcrion	direction
viking:	viking
winslate	winslet
gosling's	gosling
athlon2	athlon
pratchett's	pratchett
seborrhoischem	seborrhoisches
burrito's	burrito
stepstone:	stepstone
perioraler	periorale
rundlichem	rundliches
haarfrisurue	haarfrisuren
galaxt	galaxy
immobeilin	immobilien
dakıka	dakika
amitamin®	amitamin
yufkasından	yufkasindan
verborgende	verborgene
dicaprio's	dicaprio
ideapad®	ideapad
christmal	christmas
minevill	mineville
komsomolskaj	komsomolskaja
erogenen	erogene
walker's	walker
frotuna	fortuna
sailir	sailor
überfällig,	überfällig
aramanı	aramani
raumfeld®	raumfeld
middlton	middleton
hartest	hardest
vampite	vampire
manoram	manorama
cashys	caschys
cassipeia	cassiopeia
arttıran	artiran
éblouie	eblouie
infnite	infinite
zonealarm®	zonealarm
roechelt	röchelt
sahnelios	sanhelios
insidehoop	insidehoops
ratiopharm®	ratiopharm
bieber's	bieber
haberler,	haberler
silvstedts	silvstedt
abgesichertem	abgesicherten
acronis®	acronis
azaela	azalea
donwton	downton
dakkika	dakika
turkıyeden	turkiyeden
eğitimin	eğitim
artertons	arterton
veronika's	veronikas
shippuude	shippuuden
gerodie	geordie
trsitana	tristana
mcgee’s	mcgee's
immöblien	immobilien
kahvozein	kahvozeins
shake:	shake
lindström:	lindström
sheerans	sheeran
gruenstich	grünstich
diairies	diaries
wukung	wukong
sheeron	sheeran
huekuemet	hukumet
landruts	landrut
wahlberg's	wahlberg
sawtzki	sawatzki
(universal	universal
refujio	refugio
screenshit	screenshot
night´s	night's
brewste	brewster
riddick:	riddick
frisurenn	frisuren
uptin	upton
diaries,	diaries
überfallig	überfällig
jezeera	jazeera
^kanal	kanald
warloard	warlord
tyndramere	tryndamere
hydrophobia:	hydrophobia
cassolare	casolare
redamtion	redemption
tansiyonda	tansiyon
kardashia	kardashian
eßlinger	esslinger
effecr	effect
astroliji	astroloji
irealia	irelia
svećenikova	svecenikova
erzreal	ezreal
r/amatur	amateur
jackman's	jackman
horizont,	horizont
braeunlicher	bräunlicher
junglke	jungle
j1mbo's	jimbos
duraği	duragi
walkinh	walking
showun	show'un
haarschniite	haarschnitte
köşeyi	köseyi
deadrische	daedrische
efefct	effect
forecasr	forecast
effect:	effect
freek'n	freakin
feines,	feines
dellö	dello
duennes	dünnes
kardashain	kardashian
franc24	france24
hilärer	hiläre
trendrisuren	trendfrisuren
fantaschtische	fantastische
timepo	tiempo
hundertjaehrige	hundertjährige
alysan	alyson
kardashian,	kardashian
schueelr	schueler
lautner's	lautner
caityln	caitlyn
combat4	combat
noctunre	nocturne
bradshaw's	bradshaw
bard´s	bard's
wotson	watson
falaxy	galaxy
kalkbrenner,	kalkbrenner
mackolikk	mackolik
apsire	aspire
daedrischen	daedrische
makkatsch	makatsch
jon’s	jon's
diaries.	diaries
traegst	trägst
seyfriend	seyfried
forecst	forecast
fahlem	fahlen
wwwpinoy	www.pinoy
fiddlestick	fiddlesticks
nidallee	nidalee
comstocks	comstock
live®	live
mahone's	mahone
gslaxy	galaxy
karadshian	kardashian
walkiing	walking
kapitalismus:	kapitalismus
ketchums	ketchum's
liverly	lively
daniki	danik
trendfrisören	trendfrisuren
www.vcontakte.ru	www.vkontakte.ru
schmalere	schmale
maokei	maokai
kickend	kickende
kuşluk	kusluk
voyager:	voyager
hiltons	hilton
imtrend	trends
dorection	direction
goerdie	geordie
fertilitaetsmonitor	fertilitätsmonitor
hatheway	hathaway
meisterklassen	meisterklasse
machigatteiru.	machigatteiru
pantehon	pantheon
knudalon	knu'dalon
moubasher	mubasher
resultato	risultati
renagr	rengar
forecats	forecast
inpeed	indeed
denisé	denise
(everything	everything
atlitikes	athlitikes
swanpoel	swanepoel
mitesse	mitesser
jennifee	jennifer
mogu'dar,	mogu'dar
hükumet	hükümet
mitellang	mittellang
orgadmus	orgasmus
anantomy	anatomy
elemenatry	elementary
dakiki	dakika
pottee	potter
returns,	returns
www.michellin	www.michelin
schweinsteigers	schweinsteiger
www:immobilienscout	www.immobilienscout
infinte	infinite
katzenbergers	katzenberger
hunzike	hunziker
imirzalioğlu	imirzalioglu
gūnesi	günesi
yorrick	yorick
cheerlearder	cheerleader
foghters	fighters
dililah	delilah
dcanli	d'canli
duty®	duty
walkig	walking
weizenböck	weitzenböck
dobrevs	dobrev
yedilide	yedili
midellton	middleton
knightleys	knightley
gametyp	gametype
unreiner	unreine
gultepe	gültepe
mirnada	miranda
braekers	breakers
halies	hailies
shppuuden	shippuuden
legedns	legends
kardaschian	kardashian
reckins	reckin's
entkoffeinierten	entkoffeinierter
hanningan	hannigan
absetzten	absetzen
hombres,	hombres
wikinson	wilkinson
kamasautra	kamasutra
chogath	cho'gath
hunington	huntington
wreckling	wrecking
lingings	linings
hadest	hardest
tyndamere	tryndamere
abramović	abramovic
thronea	thrones
schmerzarme	schmerzfreie
stdadoll	stardoll
(unrated	unrated
teimpo	tiempo
warfare®	warfare
schmiedemeisters	schmiedemeister
warchers	watchers
reicht's	reichts
mccathy	mccarthy
rihanma	rihanna
karambowlage	karambolage
schöneberge	schöneberger
kamekatzen	kamikaze
www.frieseure	www.frisuren
scheide.	scheide
aufgeblahter	aufgeblähter
kurzharrfrisuen	kurzhaarfrisuren
shuppuden	shippuden
vorgeschrieben,	vorgeschrieben
fantasy:	fantasy
storecenter	storcenter
daioly	daily
dschango	django
r/spring	spring
blurres	blurred
orcania	ocarina
corrire	corriere
gunesi	günesi
dimishing	diminishing
jackmans	jackman
deschannel	deschanel
roscón	roscon
huffingten	huffington
collpix	coolpix
strahovsky	strahovski
schwerter,	schwerter
kohlenhydratloses	kohlenhydratarmes
pantheo	pantheon
bedingtem	bedingter
gouling	goulding
wawrick	warwick
schoppornou	schoppernau
midletton	middleton
kendirck	kendrick
incleed	indeed
grossporige	großporige
ritualsteine	ritualstein
nichtsteroidalen	nichtsteroidale
vampore	vampire
10minute	minute
anatony	anatomy
bisuttis	bisutti
quiché	quiche
güneşi	günesi
areason	reason
icomanoa	icomania
claudell	claudelle
östrogenfreier	östrogenfreie
makasch	makatsch
claptons	clapton
pussícat	pussycat
hofscheuer	hofschuir
nasusu	nasus
sasmazin	sasmaz
longoria,	longoria
spellflash:	spellflash
hutchersons	hutcherson
thicke,	thicke
y?zyil	yüzyil
bradshaws	bradshaw
mili's	millis
yuzyil	yüzyil
develide	develi
sulemann	suleman
wakling	walking
immobiein	immobilien
uberfällig	überfällig
noctrune	nocturne
jepsens	jepsen
reminis	remini
bailout:	bailout
timberlake's	timberlake
walkng	walking
qwanss	qwans
tributen	tribute
halaxy	galaxy
komedogener	komedogen
gewalttaetig	gewalttätig
akalinin	akalin
wouneng	wohnung
biebet	bieber
wouhnug	wohnung
chronike	chroniken
versteuernde	versteuerndes
bouncig	bouncing
allgemeen	algemeen
diretta.	diretta
pozision	position
zamankı	zamanki
unchained,	unchained
stagnetti's	stagnettis
frisuren#	frisuren
malasyian	malaysia
oktomom	octomom
posistions	positions
yollarida	yollari
hobbit:	hobbit
grasflecke	grasflecken
gangblank	gangplank
anatmoy	anatomy
feirha	feriha
invasion:	invasion
savaşi	savasi
akrham	arkham
tesadufleri	tesadüfleri
barrymoore	barrymore
diariea	diaries
thones	thrones
nocturen	nocturne
schàfer	schäfer
incomania	icomania
fragezeichen,	fragezeichen
boehlitz	böhlitz
iconania	icomania
evelyyn	evelyn
erotisvhe	erotische
orgasmzs	orgasmus
pointstrek	pointstreak
weathrr	weather
nidalle	nidalee
gesichtform	gesichtsform
l'oroscopo	oroscopo
kardashians:	kardashians
ekenomi	ekonomi
piranha!	piranha
divinity:	divinity
molly’s	molly's
kadarshian	kardashian
stinson's	stinson
vkontakte.	vkontakte
aederchen	äderchen
angels	angel's
hauscka	hauschka
d’adèle	d'adèle
pepper’s	pepper's
kardashina	kardashian
tv44hc	tv43hc
3ultimate	ultimate
nautlius	nautilus
maktuelle	aktuelle
azalea's	azalea
huffingotn	huffington
aliens:	aliens
lvdalen,	Älvdalen,
ganplank	gangplank
harmony®	harmony
aufgeblaehter	aufgeblähter
citadel:	citadel
mikorys	mikory
middeltons	middleton
genuegend	genügend
monogamen	monogame
perioralen	periorale
holmes:	holmes
gankplank	gangplank
mordekasier	mordekaiser
gepgraphic	geographic
nithing	nothing
porbstars	pornstars
malphit	malphite
ecelstone	ecclestone
balotelli's	balotelli
redeption	redemption
www.gazetta	www.gazzetta
1.periode	periode
adicting	addicting
vamprie	vampire
wàhrend	während
srolls	scrolls
zerfallener	zerfallene
posistion	position
melphite	malphite
fasülye	fasulye
eroberers]	eroberers
cressidas	cressida
mother:	mother
pannettiere	panettiere
galaxx	galaxy
kutcher's	kutcher
strafferer	straffer
gakaxy	galaxy
wreacking	wrecking
rejion	region
m.onet.pl	onet.pl
maphite	malphite
kagawas	kagawa
^justin	justin
chezeburger	cheezburger
direction:	direction
shippuuuden	shippuuden
erober	erobere
hammerlocks	hammerlock's
wasserreichste	wasserreichster
aguileras	aguilera
geliner	gelinler
hametum®	hametum
renecton	renekton
rtl8168b/8111b	rtl8168/8111
wwww.monster	www.monster
ascape	escape
elemental:	elemental
jeanne,	jeanne
vijoline	violine
watsen	watson
vandaven	vandeven
bellucci,	bellucci
morgan´s	morgan's
abgesichter	abgesicherter
information\	information
grunstich	grünstich
wargame:	wargame
gazetto	gazzetta
lumineer	lumineers
barracude	barracuda
generels	generals
indepndent	independent
johansson's	johansson
frysuren	frisuren
gündesin	gündes
tv43hc	tv11hc
narzischtische	narzisstische
burred	blurred
fingere	finger
nothing:	nothing
blitzcranc	blitzcrank
hudgen	hudgens
yüzyilin	yüzyil
conquer:	conquer
mumfords	mumford
effect3	effect
anistone	aniston
uizending	uitzending
whatson	watson
kekillis	kekilli
frisuuren	frisuren
naidoo:	naidoo
icomana	icomania
dechanel	deschanel
fishburne's	fishburne
thirft	thrift
kardashiyan	kardashian
honigman	honigmann
sölitaire	solitaire
globovisión	globovision
kardashyan	kardashian
krhaarschnitte	kurzhaarschnitte
shan´ze	shan'ze
fuerstenfeldbrucker	fürstenfeldbrucker
allistar	alistar
barth:	barth
kleinesorge	kleinsorgen
franziger	fransiger
de.monster	www.monster
howars	howard
lawrenc	lawrence
forgives,	forgives
sheeram	sheeran
volibaer	volibear
salatü	salatu
chogaht	cho'gath
inifinite	infinite
abbehmen	abnehmen
goworim	govorim
regaine®	regaine
gùnesi	günesi
getoente	getönte
zehnspitzen	zehenspitzen
knockin’	knocking
raspberrz	raspberry
ezrael	ezreal
blocksbergs	blocksberg
kneightley	knightley
knightely	knightley
anrchy	anarchy
wickle	wickel
jackson:	jackson
ivomania	icomania
schweighöfers	schweighöfer
elbertzhagens	elbertzhagen
teeenage	teenage
legneds	legends
maistream	mainstream
bugûnki	bugünkü
buellers	bueller's
bioshock:	bioshock
vvkontakte.ru	vkontakte.ru
icomanie	icomania
obstruktiver	obstruktive
fernanschluß	fernanschluss
schÃ¶ner	schöner
erotischr	erotische
götheturm	goetheturm
nhyria	nhyira
schönesten	schönsten
kettenreaktions	kettenreaktion
gankplang	gangplank
dailoy	daily
ayşeyi	ayseyi
spears.	spears
gazeta.	gazeta
weeknd)	weeknd
www.micheline	www.michelin
uhrahnen	urahnen
prenlauer	prenzlauer
feelixgotze	feelixgotze19
fältskog,	fältskog
pornsrars	pornstars
brightsight	brightside
middeton	middleton
Überfällig	überfällig
butterblätzchen	butterplätzchen
rtl8201	rtl8201cl
sailot	sailor
wlking	walking
kog´maw	kog'maw
fragezeiche	fragezeichen
kouchou:	kouchou
legend's	legend
borrisov	borisov
icimania	icomania
fassbenders	fassbender
devolpers	developers
kurzhaarfruisur	kurzhaarfrisuren
maplhite	malphite
glanzlosem	glanzloses
langoria	longoria
vendeven	vandeven
friszren	frisuren
basara:	basara
besutiful	beautiful
mordekaise	mordekaiser
siedler:	siedler
karataşta	karataş
fantady	fantasy
huffigton	huffington
bezwingers]	bezwingers
beautfiul	beautiful
radcliffe's	radcliffe
kurzhhar	kurzhaar
genugend	genügend
caytlin	caitlyn
galalxy	galaxy
couting	counting
wieskie	wiejskie
dekinai.	dekinai
volibär	volibear
scrools	scrolls
yuzyill	yuzyil
justin.	justin
ungeschminckt	ungeschminkt
beklerken.	beklerken
pornstarz	pornstar
kikende	kickende
dicaprios	dicaprio
downpur	downpour
posterin	posterine
schwarzenegger's	schwarzenegger
riganna	rihanna
vliegenden	vliegende
güzelbahçede	güzelbahçe
galady	galaxy
fluorette	fluoretten
richender	riechender
galsxy	galaxy
gelten,	gelten
nari,	nari
clooney's	clooney
jennete	jennette
beschnittenem	beschnittenen
abgesetz	abgesetzt
dedire	desire
silikone,	silikone
nothing’s	nothing's
1.ultraschall	ultraschall
hoffington	huffington
thunder:	thunder
postnatalen	postnatale
İvedik	ivedik
aufgeblähtem	aufgeblähter
jon´s	jon's
middleton:	middleton
mangekyō	mangekyou
diearies	diaries
uitzendig	uitzending
irilia	irelia
blured	blurred
tarafsız	tarafsiz
caucinha	calcinha
wwww.kostenlos	www.kostenlos
erfolg:	erfolg
murders:	murders
dosierter	dosierte
klitzekleines	klitzeklein
ereğlide	ereğli
mercurys	mercury
trensfrisuren	trendfrisuren
tienpo	tiempo
weaterh	weather
christina.	christina
icomenia	icomania
anasie	anansie
anvilsund	ansilvund
soezcue	sozcu
wochunug	wohnung
wandelne	wandelnde
tryndamer	tryndamere
risugami’s	risugami's
jovovitch	jovovich
bestbezahlten	bestbezahlte
pottet	potter
königsbücher	königsbüscher
alking	walking
wochs	wachs
scherzingers	scherzinger
chaisy	chasey
cchords	chords
malzhar	malzahar
chordws	chords
übelkeits	übelkeit
sch�ner	schöner
moobafire	mobafire
kelebeyin	kelebegin
chivalry:	chivalry
werneuchen.	werneuchen
hip/hop	hiphop
buienradar.	buienradar
kardeschian	kardashian
nidale	nidalee
kuehles	kühles
bojangle	bojangles
fiddelsticks	fiddlesticks
hattrick.	hattrick
shadowruns	shadowrun
braunlicher	bräunlicher
iconomia	icomania
blitzkrank	blitzcrank
monac'o	monaco
guitarrists	guitarists
goudling	goulding
fruchbaren	fruchtbaren
hourglasses	hourglass
fishburnes	fishburne
waliking	walking
atherium	aetherium
anisto	aniston
ericssons	ericsson
icomanis	icomania
bobfrsuren	bobfrisuren
geschädigtem	geschädigtes
timerberlake	timberlake
sekreto	segreto
l,afrique	l'afrique
aniston's	aniston
drakensang:	drakensang
chogat	cho'gath
òroscopos	horoscopo
ratgber	ratgeber
irellia	irelia
Åkerman	akerman
cekirdegin	cekirdeginin
tschirna	tschirner
waston	watson
ender’s	ender's
nothign	nothing
bahtsız	bahtsiz
hakescher	hackescher
trundel	trundle
seleba	selena
triumfo	triunfo
anarchy,	anarchy
forlon	forlorn
irgasmus	orgasmus
syncing:	syncing
jormungand:	jormungand
somerhalde	somerhalder
trauberts	traubert's
schuelr	schueler
washongton	washington
farbentrends	farbtrends
piraten!	piraten
mountaion	mountain
hotterst	hottest
ditection	direction
grey’s	grey's
fallings	falling
choreds	chords
diariode	diario
blasenentzümdung	blasenentzündung
ofkeli	öfkeli
feinem	feines
redemptio	redemption
riechenden	riechender
reiszeit	reisezeit
cho´gath	cho'gath
couco	cuoco
chichi:	chichi
lahnterrassen	lahnterrasse
trendfriesur	trendfrisuren
devil’s	devil's
wetten,	wetten
xoeria	xperia
scolls	scrolls
shontelle's	shontelle
throns	thrones
uitsending	uitzending
malzahr	malzahar
belerken	beklerken
navabharat	navbharat
icomanio	icomania
chorfds	chords
timberlakes	timberlake
fnatasy	fantasy
grande's	grande
schuld,	schuld
treasure:	treasure
timberlke	timberlake
niggasin	niggas
mountail	mountain
keiserliche	kaiserliche
isaretin	isareti
aderchen	äderchen
.tar.bz2	tar.bz2
refaelis	refaeli
wohnu.g	wohnung
aldrins	aldrin
throwns	thrones
icomani	icomania
idepad	ideapad
soldiers:	soldiers
absplitternde	splitternde
mentalsit	mentalist
(yuandao)	yuandao
horosocopo	horoscopo
sister’s	sister's
ungekündigte	ungekündigter
daiuly	daily
kurzhaarfrisuren,	kurzhaarfrisuren
flippice	flippige
moskova’nın	moskova'nın
kuroinu:	kuroinu
icumania	icomania
zweieige	zweieiige
amandy	amanda
diaires	diaries
überfällig.	überfällig
fiddlsticks	fiddlesticks
hueftspeck	hüftspeck
frisurern	frisuren
ronaldo's	ronaldo
sitelike	siteslike
kaufsüchtige	kaufsüchtig
dirtback	dirtbag
timerlake	timberlake
fidlesticks	fiddlesticks
tryndamare	tryndamere
humanitys	humanity's
riechendem	riechender
wearher	weather
massacre:	massacre
kidman's	kidman
arslans	arslan
yurdanurun	yurdanur
postitions	positions
icomsnia	icomania
livley	lively
tatsachlich	tatsächlich
reichesten	reichsten
prezlauer	prenzlauer
borisow	borisov
sheern	sheeran
sucheintraege	sucheinträge
wilkonson	wilkinson
combat:	combat
gulding	goulding
renketon	renekton
brealing	breaking
feuersalz	feuersalze
ratsel	rätsel
turtles:	turtles
waechst	wächst
thausand	thousand
aguillera	aguilera
galaxz	galaxy
williams's	williams
jusrin	justin
payday:	payday
weathwr	weather
khalifas	khalifa
rangers:	rangers
schweigers	schweiger
fettenden	fettendes
falzmarke	falzmarken
seyfield	seyfried
wearther	weather
pfeifferschem	pfeiffersches
cctogo.	cctogo
altınkumda	altınkum
weatrher	weather
corssing	crossing
postnataler	postnatale
crucibel	crucible
saatilik	satilik
friusuren	frisuren
teebu's	teebus
brautfrisueren	brautfrisuren
cecelı	ceceli
flashpoint:	flashpoint
gazetta	gazzetta
ansiton	aniston
effect1	effect
ramsay's	ramsay
raider:	raider
kommunikationskontroller	kommunikationscontroller
colappse	collapse
ekko)	ekko
günesı	günesi
scissorshands	scissorhands
penzlauer	prenzlauer
rtve24h	rtve24
mantisgarnelen	mantisgarnele
destineys	destiny's
qwan's	qwans
xhao	zhao
pattionson	pattinson
panettieres	panettiere
mühtesem	muhtesem
chrsitmas	christmas
diareis	diaries
koala's	koalas
weathher	weather
aguiliera	aguilera
demption	redemption
cjhords	chords
celebrity,	celebrity
morderkaiser	mordekaiser
abnehmeb	abnehmen
anlagaobjekte	anlageobjekte
yuzyıl	yuzyil
countert	counter
fanrasy	fantasy
lawrance	lawrence
verstopftem	verstopften
seyfrieds	seyfried
schneidungs	schneiden
kasadin	kassadin
www.vkontаkte.ru	www.vkontakte.ru
lustropfen	lusttropfen
ip4200x	ip4200
gefilterter	gefilterte
ramsays	ramsay
erotsiche	erotische
tuc.	tuc
telegraaf.	telegraaf
dauily	daily
leitmayer	leitmayr
delevinge	delevingne
gulerin	güllerin
icomanua	icomania
coopix	coolpix
legemds	legends
lawerence	lawrence
fiddelstick	fiddlesticks
ammumu	amumu
blitcrank	blitzcrank
resugamis	risugamis
aljaziera	aljazeera
league:	league
mılliyet	milliyet
optmus	optimus
truinfo	triunfo
kalorienen	kalorien
himitsu:	himitsu
selungen	stellungen
gazetesini	gazetesi
dysseldorf	düsseldorf
juengste	jüngste
blasentzündung	blasenentzündung
fruchhöhle	fruchthöhle
ulusoyun	ulusoy
ceyhanin	ceyhan
mosbys	mosby's
tayfurun	tayfur
garveys	garvey
shippūden:	shippuden
skarna	skarner
wweather	weather
çakallarla	cakallarla
wâhrend	während
tistale	tisdale
chorsds	chords
roostbeef	roastbeef
absezten	absetzen
goessner	gössner
penelopez	penelope
multisync®	multisync
güvercinlikte	güvercinlik
profee	profree
armstrong.	armstrong
onkelz,	onkelz
oestmanns	oestmann's
komtakte	kontakte
jennufer	jennifer
brakers	breakers
khazix	kha'zix
wetaher	weather
icomanina	icomania
underwood's	underwood
digtial	digital
ffrisuren	frisuren
brekaing	breaking
beinplatte	beinplatten
himberblättertee	himbeerblättertee
neosis	noesis
lidschattenfarben	lidschattenfarbe
financieele	financieel
grießmühle	griesmühle
galaxy<	galaxy
luffy:	luffy
angels’	angels
tomaotes	tomatoes
prenzlaur	prenzlauer
gepflogenheit	gepflogenheiten
borrisow	borisov
schoneberger	schöneberger
trizyklischen	trizyklische
cuoco's	cuoco
celebtrity	celebrity
kürtlar	kurtlar
sprachsteuerungs	sprachsteuerung
schleimtropf	schleimpfropf
ecclestones	ecclestone
bardots	bardot
levine's	levine
negativ,	negativ
dr.müllers	dr.müller
�bersetzergoogle	übersetzergoogle
mondelfe	mondelfen
furious:	furious
gaöaxy	galaxy
forecase	forecast
sodakika	dakika
diaminds	diamonds
drachenzaehmen	drachenzähmen
latidude	latitude
beschützers]	beschützers
cosgroven	cosgrove
origings	origins
fdaily	daily
enchanced	enhanced
hutcherson's	hutcherson
d'auguri	auguri
vorzuegen	vorzügen
darmową	darmowa
breakimg	breaking
diamnods	diamonds
clearblu	clearblue
hatherway	hathaway
rtl8168/811	rtl8168/8111
monteiths	monteith
fragezeichn	fragezeichen
fernsegen	fernsehen
angestuft	gestuft
trndige	trendige
monpoly	monopoly
poinstreak	pointstreak
fabíola	fabiola
thousan	thousand
süleymanin	süleyman
tenaciuos	tenacious
absetzte	absetzen
kardischan	kardashian
feminisierungs	feminisierung
galacy	galaxy
schoemburg	schömburg
elsecreto	secreto
malpite	malphite
juengerer	jüngerer
wicther	witcher
distels	distel
bilson's	bilson
icomania.	icomania
thikpad	thinkpad
huffingon	huffington
kardahsian	kardashian
direciton	direction
srellungen	stellungen
jennett	jennette
icomamia	icomania
betruegt	betrügt
geburtsvorbereitender	geburtsvorbereitende
amamda	amanda
internetgeschwindigkeits	internetgeschwindigkeit
hukümet	hükümet
silikonfreiem	silikonfreies
detctive	detective
ominösen	ominöser
leno's	leno
ausfluß	ausfluss
anniston	aniston
galayxy	galaxy
downpoor	downpour
stellungn	stellungen
abgestzt	abgesetzt
worldest	worlds
canesten®	canesten
.immobilienscout	immobilienscout
wilkison	wilkinson
maxïmo	maximo
cassopeia	cassiopeia
waling	walking
hufington	huffington
computernamen	computername
immoneten	immonet
weatger	weather
hugdens	hudgens
pathcer	patcher
counetr	counter
justive	justice
ocunter	counter
radeaon	radeon
lesebestätigungen	lesebestätigung
timeberlake	timberlake
chhords	chords
expeditions:	expeditions
chordsw	chords
phanteon	pantheon
uebergibt	übergibt
xperoa	xperia
schuchow	schwuchow
rounds:	rounds
shippudden	shippuuden
meitwohnug	mietwohnung
postitionen	positionen
seyıt	seyit
vkantakte.ru	vkontakte.ru
jahrestags	jahrestag
forescast	forecast
jimbos	jimbo's
çakmakta	çakmak
texutre	texture
deadric	daedric
thinkpad®	thinkpad
chorrds	chords
fristuren	frisuren
tusculo	tuscolo
schlàft	schläft
cleanin	cleaning
kaufenin	kaufen
dowton	downton
kinoprogramn	kinoprogramm
gunlük	günlük
hökümet	hükümet
gouldin	goulding
chpords	chords
corrreo	correo
octomum	octomom
eiichirō	eiichiro
swanepol	swanepoel
yufkasiyla	yufkasindan
slender's	slender
driection	direction
antomy	anatomy
savatzki	sawatzki
epelieren	epilieren
fruchtbarste	fruchtbare
trunde	trundle
watchers,	watchers
bramks	bramka
blasenentzüdung	blasenentzündung
auguilera	aguilera
Çakallarla	cakallarla
theramor	theramore
luminers	lumineers
chordds	chords
caitly	caitlyn
warfram	warframe
neukönigsförderer	neukönigsförder
laineys	lainey
herztone	herztöne
flanagen	flanagan
scrolls:	scrolls
dragins	dragons
hanekes	haneke
nailin’	nailin
biebers	bieber
längeres,	längeres
duenes	feines
caillait	caillat
shockin	shocking
kaltik	kal'tik
schuppende	schuppige
choprds	chords
icomaia	icomania
baratheons	baratheon
porn's	porn’s
shipuuden	shippuuden
džungla	dzungla
kardashi	kardashian
waehrend	während
malhazar	malzahar
1mmobilien	immobilien
demirerin	demirer
huntigton	huntington
comerci	comercio
50shades	shades
beckham's	beckham
bröckliger	bröckeliger
kendrik	kendrick
lovescope	horoscope
tchords	chords
snydra	syndra
championlar	sampiyonlar
frack`s	fracks
ezeral	ezreal
commander:	commander
uomine	uomini
mittagschlaf	mittagsschlaf
fakır	fakir
assaasins	assassins
sheraan	sheeran
grönemeyers	grönemeyer
fz150eg	fz150egk
stewart's	stewart
versandbedingungen.	versandbedingungen
fruchbare	fruchtbare
athousand	thousand
anaphylaktischen	anaphylaktischer
misérables	miserables
wärmeleitpasten	wärmeleitpaste
blasenentündung	blasenentzündung
gutschri­ft	gutschrift
ausscharbung	ausschabung
o'reilley	o'reilly
gramde	grande
colchium	colchicum
midddleton	middleton
chiords	chords
ausgluss	ausfluss
einwachsende	eingewachsene
kontakte.	kontakt
trohnes	thrones
andrson	anderson
üzulme	üzülme
sexualitäts	sexualität
abstillen,	abstillen
pirnstar	pornstar
gangnam.	gangnam
arkaham	arkham
cobain's	cobain
schweissdrüsen	schweißdrüsen
tschirne	tschirner
wahrend	während
geforce®	geforce
atronarch	atronach
klaxxis	klaxxi
dickflussiger	dickflüssiger
rossiskie	russkie
wohnhng	wohnung
polyesters	polyester
rizolie	rizzoli
agtrio	a.g.trio
khartus	karthus
wachst	wächst
hufflington	huffington
throxin	thyroxin
deadra	daedra
huftspeck	hüftspeck
geloeschte	gelöschte
festivsl	festival
elmalı	elmali
liftaktiv	liftactiv
chrords	chords
partnerprofile	partnerprofil
weathre	weather
lukyanovas	lukyanova
limasol	limassol
sauberung	säuberung
portugal.	portugal
donnerwetter,	donnerwetter
lawence	lawrence
sturmer	stürmer
ntel(r)	intel(r)
hill:	hill
xperis	xperia
latikas	latika's
cholchicum	colchicum
cameren	cameron
v10ipb	v10ipw
glalaxy	galaxy
ausluss	ausfluss
jarven	jarvan
thrawns	thrawn's
diebesgilden	diebesgilde
kindbewegungen	kindsbewegungen
travolta's	travolta
limonluda	limonlu
tamburine	tambourine
hitman:	hitman
rafeli	refaeli
raedeon	radeon
olvidos	olvido
daruis	darius
zyklushaelfte	zyklushälfte
gaalaxy	galaxy
hobbit,	hobbit
upskirt:	upskirt
karnindaki	karninda
übertragunsrate	übertragungsrate
orkanschwingen	orkanschwinge
chordfs	chords
kogmaw	kog'maw
pinkeln.	pinkeln
enthaltende	enthalten
chordss	chords
owhnung	wohnung
weatehr	weather
weeather	weather
stoehnt	stöhnt
celolite	cellulite
dogma:	dogma
polakken	polacken
eigetnumswohnung	eigentumswohnung
trimagische	trimagisches
slidin	sliding
berherrn,	Überherrn,
cercanías	cercanias
orgasmud	orgasmus
blasenetzündung	blasenentzündung
shipuudden	shippuuden
lahanası	lahanasi
kalkhaltigem	kalkhaltiges
bugünun	bugünün
nothinh	nothing
assmannshauser	aßmannshauser
veiger	veigar
caribbean:	caribbean
mavisehirde	mavisehir
khaziks	kha'zix
tockene	trockene
Şifresi	şifresi
callait	caillat
baeuerchen	bäuerchen
fanzasy	fantasy
blasenentzünung	blasenentzündung
diraries	diaries
lampoon’s	lampoon's
seitenumbrüche	seitenumbruch
pirnstars	pornstars
lonesom	lonesome
l’wren	l'wren
reservierungsgebühren	reservierungsgebühr
blindless	blindness
lawrenze	lawrence
choliken	koliken
trydamere	tryndamere
jungferhäutchen	jungfernhäutchen
sorgunda	sorgun
verheiratetem	verheirateten
perioale	periorale
vorhölzer	vorhoelzer
gelösche	gelöschte
leviathan:	leviathan
zellveränderungen	zellveränderung
waschsen	wachsen
bloonds	bloons
www.tuneln	www.tunein
amargedom	armagedon
fishbourne	fishburne
verraeter	verräter
welligem	welliges
ruyasi	rüyasi
jetzte	jetzt
audioausgabegeräte	audioausgabegerät
eljazeera	aljazeera
broadwell,	broadwell
aconia	iconia
wunderwaffel	wonderwaffel
auschabung	ausschabung
celabrity	celebrity
spele.	spele
nexus 7	nexus7
überflutetes	überflutete
wars®	wars
faltmarken	falzmarken
blitzcranck	blitzcrank
bekleren	beklerken
9mmobilien	immobilien
larence	lawrence
realismen	realism
longria	longoria
norhing	nothing
ulzimate	ultimate
anzeichn	anzeichen
dominon	dominion
kenndrick	kendrick
nobody’s	nobody's
schleimpfropfen	schleimpfropf
turmverteidigungs	turmverteidigung
erdmanns	erdmann
wilkinsons	wilkinson
mountion	mountain
schwangerschftstest	schwangerschaftstest
zaubre	zaubere
freunsin	freundin
router's	router
parade´s	parade's
currecny	currency
bräunlichem	bräunlicher
zaldana	saldana
wenworth	wentworth
wiederholungszeilen	wiederholungszeile
vaigar	veigar
bruderschafts	bruderschaft
bigaja	bigaia
nothimg	nothing
jugnel	jungle
kenzul	kenzül
phenomii	phenom
selbstbraeuner	selbstbräuner
schlecki	schlecky
cumhüriyet	cumhuriyet
abeautiful	beautiful
directiom	direction
strapaziertem	strapaziertes
schoenheitsreparaturen	schönheitsreparaturen
bleechen	bleichen
slater's	slater
slender:	slender
srewart	stewart
muntant	mutant
darbanville	d'arbanville
chortds	chords
kohlenhydratlose	kohlenhydratarme
ümitköyde	ümitköy
marriam	merriam
galayy	galaxy
directio	direction
weaather	weather
bauermhof	bauernhof
shippden	shippuden
fuffis	fuffies
unforgive	unforgiven
karinina	karenina
traubert	traubert's
malzaha	malzahar
lósteria	l'osteria
sturmfuhrer	sturmführer
simpsons:	simpsons
rieman	riemann
prinzen,	prinzen
theron,	theron
seelena	selena
buecherdiebin	bücherdiebin
eiweisreiche	eiweißreiche
icomnia	icomania
sientist	scientist
fruchthöle	fruchthöhle
octomon	octomom
gruenlicher	grünlicher
eucerin®	eucerin
ozderede	özderede
brustverkleinerungs	brustverkleinerung
lagerfelds	lagerfeld
bieber.	bieber
terrarua	terraria
bomer's	bomer
kleidfarbe	kleiderfarbe
merediths	meredith
bauncing	bouncing
weatjer	weather
miserables,	miserables
fryzuren	frisuren
jrnnifer	jennifer
backstree	backstreet
tempest:	tempest
jezables	jezabels
(anthony	anthony
tatlisesin	tatlises
cuoco.	cuoco
mutterbander	mutterbänder
khaosprinz	k.haosprinz
absetzen,	absetzen
redempion	redemption
corriera	corriere
origions	origins
4bilder1	bilder
octamom	octomom
daily<	daily
d.machts	machts
peridico	periodico
chetrulette	chatroulette
tv5mond	tv5monde
nickelodeon.	nickelodeon
shueler	schüler
makelose	makellose
vaiger	veigar
selbstbrauner	selbstbräuner
assassin’s	assassin's
mendereste	menderes
bräunlichen	bräunlicher
quickcam®	quickcam
unterleib,	unterleib
wttv.click	www.click
înternet	internet
televisió	televisio
.spotlight	spotlight
speedtm	speed
positiv,	positiv
muwiestar	moviestar
kuoco	cuoco
kekilli,	kekilli
goulding's	goulding
goichi	giochi
dökülmemesi	dökülmesi
drmundo	dr.mundo
coreio	correio
comdies	comedies
blasenentzünfung	blasenentzündung
jenner's	jenner
cheeleaders	cheerleader
waescht	wäscht
linnings	linings
catrall	cattrall
purge:	purge
pattinson's	pattinson
facell	facelle
trockende	trockene
bruser	brüser
revoir,	revoir
jepsen's	jepsen
fruchthülle	fruchthöhle
kirlich	kirchlich
guenesi	günesi
chappelles	chappelle
säsische	sächsische
riquelm	riquelme
efffect	effect
freubdin	freundin
daaily	daily
wethear	weather
biss)	biss
bergibt	übergibt
chaords	chords
yuzyilin	yuzyil
tyroxin	thyroxin
blasenentzünding	blasenentzündung
episofe	episode
creator,	creator
huftington	huffington
schwangrr	schwanger
vkontate.ru	vkontakte.ru
konyaaltında	konyaaltinda
ausgewogenen	ausgewogene
stecheb	stechen
eastwood's	eastwood
baldur’s	baldur's
blsenentzündung	blasenentzündung
tisdal	tisdale
origins:	origins
kurzfriseure	kurzfrisuren
novosti.	novosti
alqulier	alquiler
wotsen	watson
posetion	position
nabelschnurr	nabelschnur
affet'in	affetin
siamr	simar
przyspieszyć	przyspieszyc
trhift	thrift
trachtenberger	trachtenberg
reminde	remind
thornes	thrones
cehennemini	cehennemi
wochenfluß	wochenfluss
genkrankheiten	erbkrankheiten
frühschwangerschafts	frühschwangerschaft
wheeping	weeping
lumeneers	lumineers
hundertjährige,	hundertjährige
yperia	xperia
angestufter	gestufter
legendaere	legendäre
soflty	softly
beyoncé:	beyonce
scheangerschaftstest	schwangerschaftstest
dítalia	d'italia
aufzuhellen	aufhellen
grimore	grimoire
sqlight	sqlite
sckicke	schicke
kämmeres	kämmerers
applegat	applegate
anatomy,	anatomy
ilirija	iliria
winehouses	winehouse
differine	differin
aufhoeren	aufhören
ambrosio,	ambrosio
ko0stenlose	kostenlose
renkton	renekton
celebroty	celebrity
gemeißelte	gemeißelter
geogrphic	geographic
deutschland:	deutschland
soezcu	sozcu
choirds	chords
fruchthoehle	fruchthöhle
schauspielee	schauspieler
kindesbewegungen	kindsbewegungen
stormfall:	stormfall
noubliez	n'oubliez
cp2104	cp210x
sxhwanger	schwanger
marygold	marigold
roütenplaner	routenplaner
bueber	bieber
mornung	morning
kendick	kendrick
dosierten	dosierte
ankern,	ankern
kentyre	kintyre
brenzlauer	prenzlauer
altinkumda	altinkum
aycuma	caycuma
finpix	finepix
cyrus.	cyrus
trackmania²	trackmania
tattood	tattoo
vermachtnis	vermächtnis
wysiwig	wysiwyg
helden,	helden
festplatter	festplatte
(un)arranged	unarranged
diamnonds	diamonds
galxay	galaxy
obstruktiven	obstruktive
crukowski	cukrowski
michaels:	michaels
bekerken	beklerken
dunyadan	dünyadan
beliebstesten	beliebtesten
shacco	shaco
bloesom	bloesem
wwwspongebob	www.spongebob
tarantino's	tarantino
uoton	upton
mittellang,	mittellang
noctune	nocturne
́zix	zix
erraria	terraria
shemare	shemar
sxstellungen	stellungen
cellebrity	celebrity
spreengsteen	springsteen
dierction	direction
sächschische	sächsische
sprödem	sprödes
hacktivator	activator
wawick	warwick
.horoskop	horoskop
f7d1101v1	f7d1101
justice's	justice
kleinstreparaturen	kleinreparaturen
rafaeli	refaeli
ratajowski	ratajkowski
geograpic	geographic
elctra	electra
celebretie	celebrity
schweissgebadet	schweißgebadet
salmanin	salman
hemsworths	hemsworth
waeather	weather
fantasz	fantasy
kingsom	kingdom
leblance	leblanc
mitellange	mittellange
abgesetzt.	abgesetzt
chordas	chords
panetierre	panettiere
return:	return
pacino's	pacino
olivido	olvido
lacriox	lacroix
wan'na	wanna
painkiller:	painkiller
maffays	maffay
ubergibt	übergibt
kruzhaarfrisur	kurzhaarfrisur
jutranji	jutarnji
magersuchts	magersucht
prächtig!	prächtig
famtasy	fantasy
gatsby,	gatsby
hudgens,	hudgens
avocadokerne	avocadokern
heimdinger	heimerdinger
frrundin	freundin
henstrige	henstridge
baliki	balika
arkahm	arkham
ocnaja	ochnaya
spectraview®	spectraview
inisches	indisches
cappeli	capelli
therory	theory
nouvaring	nuvaring
hiltion	hilton
bittens	bitten's
countet	counter
orgasmis	orgasmus
erstausstattungs	erstausstattung
loeffelchen	löffelchen
galasxy	galaxy
urtlar	kurtlar
faltmarke	falzmarken
corkie	corki
fabtasy	fantasy
kindesbewegung	kindsbewegungen
cpunter	counter
audioausgabegeraete	audioausgabegerät
satiik	satilik
berserk:	berserk
geflogenheiten	gepflogenheiten
kurzhaasfrisuren	kurzhaarfrisuren
gülerin	güllerin
(excuse	excuse
breaing	breaking
lukyanova,	lukyanova
kebabin	kebabi
rowland's	rowland
blurried	blurred
frwundin	freundin
beautoful	beautiful
(staat	staat
tainded	tainted
novaković	novakovic
jennifer’s	jennifer's
forcast	forecast
portman's	portman
bayton	baytown
junglr	jungle
festpallte	festplatte
resthoff	resthof
schattenjaeger	schattenjäger
stelllungen	stellungen
hudges	hudgens
hitomie	hitomi
textture	texture
erfahrenem	erfahrenen
narzisstischem	narzisstischen
stellungen.	stellungen
blindarmentzuendung	blinddarmentzündung
pornsrar	pornstar
hubter	hunter
latidute	latitude
sherran	sheeran
wokong	wukong
fruchthohle	fruchthöhle
pillepause	pillenpause
ándrea	andrea
electrogeräte	elektrogeräte
alskar	älskar
hearthstone:	hearthstone
mirrror	mirror
schwangerschsftstest	schwangerschaftstest
knight:	knight
lchords	chords
littlw	little
Çirkin	cirkin
knightley,	knightley
heart’s	heart's
shippuden:	shippuden
befridigt	befriedigt
icmania	icomania
wrather	weather
watson's	watson
powershoot	powershot
vergiß	vergiss
besenreise	besenreiser
blasenentzûndung	blasenentzündung
frisurentipp	frisurentipps
ikomania	icomania
/effect	effect
weatherr	weather
monicca	monica
desriny	destiny
sidhartha	siddhartha
kyoujin	kyojin
cellulites	cellulite
deck:	deck
marvel’s	marvel's
bltzcrank	blitzcrank
bankrupt!	bankrupt
ideatab®	ideatab
destiny’s	destiny's
chordsd	chords
trifth	thrift
werewolf:	werewolf
verrater	verräter
spinnbarem	spinnbarer
elniak	eleniak
antiheros	antiheroes
springsteen's	springsteen
weatheer	weather
aufhoren	aufhören
kuelper	külper
westher	weather
chtistmas	christmas
nassus	nasus
nostalgia,	nostalgia
unterleib.	unterleib
weathee	weather
notepadd	notepad
m’barek	m'barek
counter#	counter
prävia	praevia
selbstbefruedigung	selbstbefriedigung
abnehmrn	abnehmen
mboafire	mobafire
temptation:	temptation
plätzchn	plätzchen
drachenrüstungen	drachenrüstung
profile	′profile
mordos	mordors
readeon	radeon
parametername:	parametername
wiedergeborenen	wiedergeborene
scoozie	scoozi
hataway	hathaway
mainstrem	mainstream
ungeschutzten	ungeschützten
gosgrove	cosgrove
bilder.ein	bilder.1
wonderall	wonderwall
risugamis	risugami's
lawrene	lawrence
faltskög	faltskog
cobains	cobain
periódicos	periodicos
limked	linked
vkontake.ru	vkontakte.ru
eliniak	eleniak
eclestone	ecclestone
yastıkta	yastikta
kareena's	kareena
walraff	wallraff
beschleifen	abschleifen
gunesı	gunesi
rihanba	rihanna
schwanher	schwanger
fuehlen	fühlen
diaetfrei	diätfrei
woodcutter's	woodcutters
redford's	redford
phantheon	pantheon
millans	millan
withcer	witcher
planet:	planet
knigthley	knightley
goulding)	goulding
frusuren	frisuren
shersey	jersey
blasenentzüngung	blasenentzündung
crossing:	crossing
huffingtom	huffington
dejanel	deschanel
webster's	webster
mittelang	mittellang
alteren	älteren
stuhlarten	stuhlfarbe
fteundin	freundin
sächssiche	sächsische
dragosn	dragons
angel’s	angel's
eifersuechtig	eifersüchtig
tousand	thousand
enthaarungscrem	enthaarungscreme
hakkenden:	hakkenden
mcarthy	mccarthy
zhix	zix
orgaamus	orgasmus
christms	christmas
www,immoscout	www.immoscout
gangsta,	gangsta
stathams	statham
cyrud	cyrus
hangin	hanging
mointain	mountain
weißheitszahn	weisheitszahn
punisher:	punisher
dittmars	dithmars
chordsa	chords
halsschmerze	halsschmerzen
lovegoods	lovegood
danganronpa:	danganronpa
movies\	movies
vollibear	volibear
heartfire	hearthfire
gewichtszunahmen	gewichtszunahme
eineiiger	eineiige
buncing	bouncing
»aspire	aspire
gaalxy	galaxy
mantisschwarm	mantisschwarms
periode,	periode
castity	chastity
polyspektran	polyspectran
hannigans	hannigan
strohigem	strohiges
vettels	vettel
bornovada	bornova
borchardts	borchardt
number()	number
eingerissener	eingerissene
radioactice	radioactive
kindsbewegung	kindsbewegungen
geograhic	geographic
maharastra	maharashtra
abführmitteln	abführmittel
astrodictum	astrodicticum
akkordr	akkorde
geordy	geordie
unterbleib	unterleib
freundon	freundin
geloschte	gelöschte
moissonier	moissonnier
zellulite	cellulite
dasily	daily
leigton	leighton
manadou	manaudou
gestort	gestört
tròdelmarkt	trödelmarkt
ägüptische	ägyptische
tatood	tattoo
weathet	weather
günluk	günlük
bilder.1	bilder
ducktales:	ducktales
d'kanal	kanald
fetige	fettige
mittesser	mitesser
unchaines	unchained
kaiufen	kaufen
spartacus:	spartacus
celebtity	celebrity
astralen	astrale
plympus	olympus
zeitueberschreitung	zeitüberschreitung
devent	deviant
erotisxhe	erotische
connely	connelly
dragpn	dragon
palermos	palermo
weather\	weather
ungeschuetzten	ungeschützten
thibgs	things
raimeter	rainmeter
monring	morning
deol's	deol
cumberbach	cumberbatch
trandige	trendige
gestochenem	gestochenes
instagrsm	instagram
iraniani	iranian
kiegler	keller
dragonval	dragonvale
sheerean	sheeran
zabriski	zabriskie
mordekeiser	mordekaiser
rowling's	rowling
potnstars	pornstar
ausfüllbares	ausfüllbare
unregelmässiger	unregelmäßiger
assassims	assassins
lonsome	lonesome
akkorede	akkorde
oerfect	perfect
emerlad	emerald
sucherin	sucher
arkhan	arkham
jennofer	jennifer
diffusem	diffuser
barnaked	barenaked
wihnung	wohnung
galaxa	galaxy
padelecki	padalecki
momford	mumford
jetzt6	jetzt
falliut	fallout
craetures	creatures
coruption	corruption
rärsel	rätsel
www.schoner	www.schoener
elebrity	celebrity
choords	chords
entchanting	enchanting
kahzix	kha'zix
kurzhaatfrisuren	kurzhaarfrisuren
dircetion	direction
satikik	satilik
lelsie	leslie
l'carnitin	carnitin
taxlor	taylor
ledger's	ledger
außfluss	ausfluss
stargader	stargarder
schwucho	schwuchow
sattilik	satilik
saijan	saiyan
cakmaklı	cakmakli
anaphylaktischem	anaphylaktischer
laengsrillen	längsrillen
synecdoche,	synecdoche
ender´s	ender's
mobafre	mobafire
cvhords	chords
bekomm	bekomme
schÖneberger	schöneberger
dreamd	dreamed
chords4	chords
kadaschian	kardashian
benfika	benfica
kadınbudu	kadinbudu
periode.	periode
thinpad	thinkpad
bootfahig	bootfähig
breakung	breaking
hiffington	huffington
uzecek	üzecek
olypmus	olympus
aufgeblähten	aufgeblähter
toucpad	touchpad
taverna,	taverna
hepburns	hepburn
responsives	responsive
komsomoljskaja	komsomolskaja
schockierend!	schockierend
gencebayin	gencebay
ddaily	daily
olymous	olympus
rebueltos	revueltos
terrraria	terraria
fragzeichen	fragezeichen
lavign	lavigne
boarwalk	boardwalk
bergès	berges
felchten	flechten
reponsive	responsive
caneron	cameron
jagger's	jagger
marca.	marca
blutkorperchen	blutkörperchen
unregelmässigen	unregelmäßiger
morissen	morrison
erotische.	erotische
enchantet	enchanted
absetze	absetzen
eisenblöcke	eisenblock
dragons:	dragons
glaxay	galaxy
miteser	mitesser
kopfverformungen	kopfverformung
danach,	danach
gangplang	gangplank
überzeug	überzeuge
lotería	loteria
luetten	lütten
baumgartners	baumgartner
tidale	tisdale
allaince	alliance
mediaset.	mediaset
icomainia	icomania
shelfshot	selfshot
porterhaus	porterhouse
papiekorb	papierkorb
infite	infinite
medicontur	medikontur
schluesselbeinbruch	schlüsselbeinbruch
warlod	warlord
sleepings	sleeping
theiry	theory
vegara	vergara
sorcerer’s	sorcerer's
athlonii	athlon
mahrough	mahroug
gazzeta	gazetta
brunches	brunch
aguilera's	aguilera
strtet	startet
scoener	schöner
blurrd	blurred
abtreibun	abtreibung
currencz	currency
erotiscge	erotische
pottter	potter
celebryt	celebrity
yüzyilda	yüzyil
dresscode:	dresscode
kor'kron]	kor'kron
bekleken	beklerken
winslett	winslet
bluerred	blurred
selbstbefriedigubg	selbstbefriedigung
komliment	kompliment
cuocos	cuoco
kurzhaarfrisureb	kurzhaarfrisuren
lisière	lisiere
daiily	daily
leaona	leona
fühlsbüttler	fuhlsbüttler
brustvergrösserungs	brustvergrößerung
wohnjng	wohnung
origns	origins
morissete	morissette
achilion	achillion
fujufilm	fujifilm
anımal	animal
orgasmaus	orgasmus
guitar.	guitar
ordnergrößen	ordnergröße
0.9.6.b5	0.9.6b5
panetterie	panettiere
schatule	schatulle
mutterbaender	mutterbänder
underwoods	underwood
telenobelas	telenovelas
www.spongbob	www.spongebob
stoffwechseln	stoffwechsel
galagy	galaxy
scnitte	schnitt
megaluf	magaluf
natalii	natalia
parton's	parton
maqazin	magazin
carmageddon:	carmageddon
o’keefe	o'keefe
löcher,	löcher
ausfluss.	ausfluss
myselfe	myself
bürüksel	brüksel
wobnung	wohnung
wiederherstellen]	wiederherstellen
leaopard	leopard
seborrhoischen	seborrhoisches
judtin	justin
arda'nin	arda'nın
experia	xperia
redeon	radeon
raedon	radeon
donnerkönigs]	donnerkönigs
fantasy13	fantasy
bieber:	bieber
rubarbe	rhubarbe
burcun	burcunun
beuerchen	bäuerchen
escaoe	escape
vossdellen	vosdellen
ausgeblieben,	ausgeblieben
kuzhaarfrisuren	kurzhaarfrisuren
mucver	mücver
babarenkönig	barbarenkönig
schumachet	schumacher
gesivht	gesicht
ispiron	inspiron
stuerzt	stürzt
icomabia	icomania
geforece	geforce
genetive	genitive
festplatt	festplatte
belivin	believing
partiion	partition
desirees	desiree's
lovely,	lovely
hackischer	hackescher
weisheitzahn	weisheitszahn
primeval:	primeval
trimagischen	trimagisches
puntuation	punctuation
kelkilli	kekilli
ansroid	android
august:	august
eperia	xperia
ultinate	ultimate
eleven2	eleven
maedchenitaliener	mädchenitaliener
eifersuchtig	eifersüchtig
svhwanger	schwanger
reiter.	reiter
glaenzende	glänzende
yüzyill	yüzyil
ceaușescu	ceausescu
selens	selena
llewin	llewyn
adlon.	adlon
sora:	sora
wohunk	wohnung
dkanal	kanald
krokoliskenbauch	krokiliskenbauch
m.a.a.d.	m.a.a.d
pundata	puntata
heimsuche	heimsuchung
jungfernhautchen	jungfernhäutchen
zerbeisst	zerbeißt
caithlyn	caitlyn
(von)	von
aussfluss	ausfluss
quoates	quotes
warlock:	warlock
railroads!	railroads
straffere	straffe
redemption:	redemption
borissow	borisov
weissheitszahn	weisheitszahn
bartholinischen	bartholinische
d´adele	d'adele
iswestia	izvestia
rhythm:	rhythm
wattson	watson
azlyric	lyrics
galaxy.	galaxy
ibrahimovics	ibrahimovic
boeregi	böregi
langsrillen	längsrillen
gate:	gate
ovguides	ovguide
fruehtest	frühtest
shining,	shining
blondere	blonde
ggalaxy	galaxy
shipudden	shippuuden
trocknes	trockenes
immobeilien	immobilien
cm18738	cmi8738
schauspueler	schauspieler
infinite:	infinite
freemaile	freemail
kamasurtra	kamasutra
himbeerblattertee	himbeerblättertee
coniuratione	coniuratio
absulution	absolution
lith'ik	lithik
freundim	freundin
withhin	within
commedies	comedies
delaneys	delaney
geisterpilze	geisterpilz
direction.	direction
aufgebläter	aufgeblähter
1.wort	ein.wort
mütakil	müstakil
sippuuden	shippuuden
silkone	silikone
nagayas	nagaya
trockens	trockenes
perfext	perfect
frosuren	frisuren
barokoko	barococo
dirntel	dirndl
cyruy	cyrus
vadisini	vadisi
conflicts:	conflicts
christams	christmas
steencamp	steenkamp
brennike	brennicke
terratia	terraria
pozitions	position
berlienr	berliner
verschwoerung	verschwörung
lalegul	lalegül
bağlari	baglari
maokia	maokai
storage:	storage
warholes	warhols
klagenden	klagende
evylin	evelyn
bestverdienenden	bestverdienende
haarsausfall	haarausfall
unheilieg	unheilig
aguielera	aguilera
rippenfellentzuendung	rippenfellentzündung
benedicks	benedick
sálvame	salvame
panetiere	panettiere
evelinn	evelynn
lonesco	ionesco
winslet,	winslet
deisre	desire
periose	periode
monster’s	monster's
gesteh	gestehe
fruchthölle	fruchthöhle
serieses	series
akusative	accusative
shipppuuden	shippuuden
layten	layton
reptide	riptide
miraak's	miraak
gossio	gossip
kedrick	kendrick
gomerim	gömerim
hatasız	hatasiz
leicos	lycos
latitute	latitude
olearys	o'learys
latiude	latitude
errinerst	erinnerst
infestation:	infestation
drahon	dragon
nebemwirkungen	nebenwirkungen
eisntein	einstein
warick	warwick
tansiyonun	tansiyon
trraria	terraria
trilogy:	trilogy
selbsrbefriedigung	selbstbefriedigung
80211n	802.11n
enchating	enchanting
d'gray	d.gray
schaeme	schäme
bombenraeumung	bombenräumung
rihanns	rihanna
lovelance	lovelace
abmehmen	abnehmen
o.n.i.f.c.	o.n.i.f.c
dieb,	dieb
gimez	gomez
bioshoch	bioshock
clarkson's	clarkson
jungrau	jungfrau
peacestanbul	peacetanbul
crosgrove	cosgrove
gotoku!	gotoku
1.anzeichen	anzeichen
jenniger	jennifer
vitmain	vitamin
selbstbefriefigung	selbstbefriedigung
scherzinge	scherzinger
ferhia	feriha
nobodys	nobody's
zustellung.	zustellung
realcom	realoem
blasenentzündungen	blasenentzündung
huffingto	huffington
terraris	terraria
gripostad	grippostad
tambourin	tambourine
initialization:	initialization
talgdruese	talgdrüse
abtreibungs	abtreibung
klums	klum
fundant	fondant
blasenenzündung	blasenentzündung
selfshoots	selfshot
economist's	economists
tequlia	tequila
(shockwave	shockwave
premonition:	premonition
coolpic	coolpix
betrugt	betrügt
jenette	jennette
senkwehn	senkwehen
icomaina	icomania
eroberes	eroberers
turkiyeden	türkiyeden
thatcher's	thatcher
schwangerschafsttest	schwangerschaftstest
verbutne	verbotene
tesbik	tesbih
pornstarss	pornstars
ferıha	feriha
cresida	cressida
kurtzhaar	kurzhaar
presto!	presto
vadise	vadisi
suspicous	suspicious
connellys	conleys
lympus	olympus
libirian	liberian
hannigen	hannigan
fruhtest	frühtest
wishes!	wishes
raider,	raider
dishonored:	dishonored
seasonn	season
blasenentzùndung	blasenentzündung
luckers	lucker
goodybye	goodbye
terrarai	terraria
ww.kostenlos	www.kostenlos
nordostfußball	nordostfussball
dövizde	döviz
lindenberg:	lindenberg
transmutieren:	transmutieren
ebsten	besten
lernte,	lernte
dakkia	dakika
schwangerschafttest	schwangerschaftstest
xperia.	xperia
verdienenste	verdienste
gnarles	gnarls
scrubs:	scrubs
tenatious	tenacious
angolina	angelina
penaut	peanut
doernen	dörnen
celebratis	celebrities
blizcrank	blitzcrank
ocarine	ocarina
barrimore	barrymore
schleimpfopf	schleimpfropf
keskinin	keskinli
jessical	jessica
aguiera	aguilera
kazooi	kazooie
kurtizin	kurtiz
morisette	morissette
herztoene	herztöne
sondakıka	sondakika
praktikumsbewerbungs	praktikumsbewerbung
kardashianin	kardashian
virutalbox	virtualbox
diamomds	diamonds
aktinischer	aktinische
c00002la	c000021a
zollhaus,	zollhaus
hormigo	hormigos
(praise	praise
camerom	cameron
sezona2	sezona
wahlbergs	wahlberg
ünlülerinin	ünlülerin
eppilieren	epilieren
helligten	hellichten
abnehmen,	abnehmen
fehgeburt	fehlgeburt
emuator	emulator
schbell	schnell
ochsenknechts	ochsenknecht
nobody´s	nobody's
enthaarungscremes	enthaarungscreme
frisuren,	frisuren
fruchtbarster	fruchtbarer
mietenin	mieten
agility4	agility
grippostadt	grippostad
inpiron	inspiron
naidoo,	naidoo
eşittir	esittir
whitely	whiteley
minecraftw	minecraft
loriell	lorielle
jolinas	jolina
schumacher's	schumacher
curency	currency
beklerke	beklerken
vijetrova	vjetrova
escape:	escape
kurzharr	kurzhaar
leigthon	leighton
horroskopi	horoskopi
thaunus	taunus
movie´s	movies
afflecks	affleck
definitely,	definitely
frisurn	frisuren
^kostenlos	kostenlos
killer,	killer
glaetten	glätten
schweißflecke	schweißflecken
berlin14	berlin
alc888s	alc888
worlds2	worlds
(traum)job	traumjob
maydonozun	maydanozun
lodestones	lodestone
kompatiblit	kompatibilit
insprion	inspiron
fagezeichen	fragezeichen
popoen	poppen
serengilin	serengil
geass:	geass
widfire	wildfire
çirkin	cirkin
bearbeitungszeile	bearbeitungsleiste
jemmifer	jennifer
jennifr	jennifer
navbhart	navbharat
malfoy's	malfoy
bauerchen	bäuerchen
fishburn	fishburne
zaehmen	zähmen
zakharova.	zakharova
chüler	schüler
durschnittslänge	durchschnittslänge
schwanfer	schwanger
^minecraft	minecraft
bowie:	bowie
galays	galaxy
abgesicherte	abgesicherter
ölyrics	lyrics
satilil	satilik
ficition	fiction
ausschabung,	ausschabung
entzuendetes	entzündetes
amargedon	armageddon
posta.	posta
erotusche	erotische
haafrisuren	haarfrisuren
merrian	merriam
camoron	cameron
radioavtive	radioactive
guitzar	guitar
fanatsy	fantasy
ultiamte	ultimate
klingelwirt	klinglwirt
electorial	electoral
ponrstars	pornstars
bleachen	bleichen
protected:	protected
faerben	färben
cravitz	kravitz
bizarer	bizarre
butterplätzen	butterplätzchen
asprie	aspire
kha´zix	kha'zix
wolfenstein:	wolfenstein
tenecious	tenacious
blasenentzündung,	blasenentzündung
dünnem	dünnes
schoeneberger	schöneberger
serverus	severus
jrooss	jrooß
kathi's	kathis
redfords	redford
grippostat	grippostad
www,pinoy	www.pinoy
hearts:	hearts
kamasutrra	kamasutra
orgamsus	orgasmus
meeten	mieten
monaco:	monaco
agazeta	gazeta
gangham	gangnam
indizierter	indizierte
beschaftigungsverbot	beschäftigungsverbot
stellungrn	stellungen
guutar	guitar
kor´kron	kor'kron
vrjeme	vrijeme
pornstara	pornstar
statussprueche	statussprüche
fz200egk	fz200eg
cassiopia	cassiopeia
lovato's	lovato
tükenmislik	tükenmişlik
amyotropher	amyotrophe
kuzhaar	kurzhaar
robbier	robbie
girlmore	gilmore
scherbatzky	scherbatsky
nuller	nullen
mbafire	mobafire
währende	während
peridoe	periode
ayşecan	aysecan
gagnam	gangnam
here´s	here's
blaseentzündung	blasenentzündung
broadwalk	boardwalk
befruchtungen	befruchtung
sxiest	sexiest
organsmus	orgasmus
muhtesen	muhtesem
frösuren	frisuren
knuppel	knubbel
wright:	wright
inspirion	inspiron
blutschwaemmchen	blutschwämmchen
heacrim	hecarim
photoshop®	photoshop
o4naja	ochnaya
skywalkers	skywalker
syvana	shyvana
übersäuerter	übersäuerung
struckture	structure
celebritiy	celebrity
dennings	denning
inanirin	inanir
pcwupdaterrepair	pcwupdaterepair
linigs	linings
jungfräuligkeit	jungfräulichkeit
galasy	galaxy
scrols	scrolls
katzenberge	katzenberger
peridode	periode
haverst	harvest
kuezhaarfrisuren	kurzhaarfrisuren
brendans	brendan's
multiboot2	multiboot
solimid	solomid
huntziker	hunziker
ehatsapp	whatsapp
withour	without
tehory	theory
dishonered	dishonored
gäb's	gäbs
thickle	thicke
torschutzenliste	torschützenliste
persiode	periode
mobilty	mobility
ivanovič	ivanovic
brustverkleinerungen	brustverkleinerung
www.kostlose	www.kostenlose
contra.	contra
kaynananin	kaynananın
auslastungs	auslastung
serienbriefen	serienbrief
innéov	inneov
enlv11hc	lv11hc
sabbath,	sabbath
haaschnitte	haarschnitte
jungeren	jüngeren
überlkeit	übelkeit
currancy	currency
mainstram	mainstream
coscrove	cosgrove
chilliad	chiliad
franzige	fransige
paradise:	paradise
mmoderne	moderne
apologies,	apologies
sternzeichn	sternzeichen
positons	positions
karruche	karrueche
terrairia	terraria
kikasse	kickass
brustvergößerung	brustvergrößerung
directin	direction
verstopfungen	verstopfung
schönhause	schönhauser
effext	effect
linekd	linked
sangría	sangria
scharnhäuser	scharnhauser
festpaltte	festplatte
galaxay	galaxy
intimberreich	intimbereich
waether	weather
eurotick	eurotic
nación	nacion
pratchetts	pratchett
carpması	carpmasi
81915pmd	8i915pmd
kezboard	keyboard
sherock	sherlock
freundib	freundin
birkebäumche	birkenbäumchen
mikrobiellem	mikrobielles
fighter:	fighter
financen	finance
beşiri	besiri
selebr	selber
terraroa	terraria
schwabger	schwanger
staiway	stairway
eşim	esim
otoshimo	otoshimono
auslagerungsdateien	auslagerungsdatei
aramisda	aramizda
reagine	regaine
eohnung	wohnung
lubbo's	lubbos
chiacchere	chiacchiere
monoke	mononoke
unteleib	unterleib
unbestellter	unbestellte
ercisson	ericsson
wijzemann	wijzeman
minogues	minogue
attack:	attack
currecy	currency
fanstasy	fantasy
calvon	calvin
ausfluss,	ausfluss
couoco	cuoco
standalon	standalone
barisov	borisov
ultimaze	ultimate
suicede	suicide
perrete	perrette
beatutiful	beautiful
niggahs	niggas
noticis	noticias
abgesezt	abgesetzt
höschchen	höschen
graumähnen	graumähne
gloreiche	glorreiche
realsim	realism
belluchi	bellucci
ozelots	ozelot
xperiatm	xperia
conjugations	conjugation
d’errico	d'errico
hochstekcfrisuren	hochsteckfrisuren
kocamın	kocamin
başlanan	başlama
dimaonds	diamonds
izwestia	izvestia
mobafrie	mobafire
retrogade	retrograde
wracking	wrecking
frsuren	frisuren
9.monate	monate
klitoralen	klitoraler
liebesliedr	liebeslieder
schã¤fer	schäfer
gosspi	gossip
ka´roz	ka'roz
glöckchen,	glöckchen
scgwanger	schwanger
jovovic	jovovich
theoriy	theory
snap.de	snap.do
gesundheitstrainer/	gesundheitstrainer
hewitts	hewitt
dragenborn	dragonborn
cypershot	cybershot
cocción	coccion
junfrau	jungfrau
lesbiqn	lesbian
cooper:	cooper
(sun	sun
terrarie	terraria
jennfier	jennifer
solariun	solarium
lenovos	lenovo
hellraiser:	hellraiser
bekimme	bekomme
reaking	breaking
urlaubstour	urlaubstours
kahlata	kehlata
pointsreak	pointstreak
sicherheitswarnungen	sicherheitswarnung
unerwiederte	unerwiderte
anistan	aniston
sherlin	sherlyn
cuocu	cuoco
chjords	chords
perioder	periode
moviews	movies
d´autet	d'autet
terraira	terraria
schamplippen	schamlippen
ntalkas	dalkas
virbrator	vibrator
übersäuerten	übersäuerung
weaher	weather
muehtesem	muhtesem
schnellbaustein	schnellbausteine
schwnager	schwanger
pocked	pocket
überkeit	übelkeit
synchmaster	syncmaster
yigioh	yugioh
www.facrbook.com	www.facebook.com
fargezeichen	fragezeichen
guettas	guetta
kombasan	kombassan
sprous	sprouse
schönere	schöne
boeber	bieber
tarot,	tarot
diamonda	diamonds
wanted2	wanted
pornatars	pornstars
delivigne	delevingne
theory:	theory
eleven3	eleven
stellun	stellung
stewarts	stewart
marough	mahroug
celulitte	cellulite
ttreeview	treeview
stalker:	stalker
dişlerin	dislerin
höttchen	höttche
pozition	position
selbstbefriedung	selbstbefriedigung
mandıra	mandira
uebelkeit	übelkeit
curreny	currency
Äderchen	äderchen
televisión	television
commadn	command
algazera	aljazeera
trendfrisüren	trendfrisuren
sahadana	sahadan
emir'in	emirin
ue46es5700s	ue46es5700
sulema	suleman
freumdin	freundin
rhagade	rhagaden
knockin	knocking
trenfrisuren	trendfrisuren
tsarnaev,	tsarnaev
kunid	kunis
fantasy8	fantasy
dungenon	dungeon
schloßkeller	schlosskeller
boatengs	boateng
japense	japanese
presedential	presidential
altersunterschiede	altersunterschied
corrirere	corriere
birber	bieber
l'112	l112
armada2	armada
baumenheim	bäumenheim
berlingen,	Überlingen,
ıngolstadt	ingolstadt
huerrriyet	hürriyet
warwik	warwick
wartunes	wartune
vamoire	vampire
elterngeld,	elterngeld
diffusen	diffuser
abhnehmen	abnehmen
taughter	daughter
coucu	cuoco
sayain	saiyan
idealpad	ideapad
digitla	digital
hackleisch	hackfleisch
exelim	exilim
taskleister	taskleiste
schönsen	schönsten
beckinsale,	beckinsale
infinate	infinite
currncy	currency
kardasyan	kardashian
freindin	freundin
brustvergrösserung	brustvergrößerung
ubelkeit	übelkeit
tanacious	tenacious
scaborough	scarborough
spanakl	ispanakli
horkrukse	horkruxe
hahnröhre	harnröhre
02micro	o2micro
waessriger	wässriger
r/flashing	flashing
süßlichen	süßlicher
impossile	impossible
sperbezirk	sperrbezirk
pressestimmem	pressestimmen
cümhuriyet	cumhuriyet
kurzhaarrisuren	kurzhaarfrisur
entchantment	enchantment
aufgehört,	aufgehört
kidmann	kidman
erfahrungsfläschen	erfahrungsfläschchen
sokakla	sokaklar
howser,	howser
eidprung	eisprung
blasenentzündubg	blasenentzündung
angeliena	angelina
tamborine	tambourine
celebritx	celebrity
drakensang2	drakensang
bourbon,	bourbon
ulrimate	ultimate
exterene	externe
d’arcy	d'arcy
wundersuppen	wundersuppe
skywalker's	skywalker
eigentumswihnung	eigentumswohnung
abnehmem	abnehmen
sheeren	sheeran
hausmädche	hausmädchen
wounong	wohnung
amummu	ammumu
progentius	progenitus
katzencafé	katzencafe
portman,	portman
thaivitas	thaivita
akbukte	akbükte
kündigungsfriste	kündigungsfrist
i̇ntikam	intikam
frauenzimmer.	frauenzimmer
orgasmua	orgasmus
schwsnger	schwanger
scientiest	scientist
dìtalia	d'italia
monafire	mobafire
surburbia	suburbia
bohrenstein	borenstein
zaehneputzen	zähneputzen
thickie	thicke
gentley	gently
celecrity	celebrity
spectrext	spectre
woodkids	woodkid
makhni	makhani
trõdelmarkt	trödelmarkt
insperion	inspiron
brüchigem	brüchiges
digity	diggity
gangnum	gangnam
cosenamen	kosenamen
otimus	optimus
gebaermutterschleimhaut	gebärmutterschleimhaut
dadika	dakika
cottillard	cotillard
itimbereich	intimbereich
schaedelbruch	schädelbruch
dondeal.ie	donedeal.ie
wshington	washington
schlaegt	schlägt
makomar	marcumar
sheeran,	sheeran
aquilera	aguilera
ecomania	icomania
hugends	hudgens
sodbrenn	sodbrennen
youtubeto	youtube
hrodulf's	hrodulfs
wettervoerhersage	wettervorhersage
şantili	santili
schwangerschaftstest,	schwangerschaftstest
gondula	gondola
banhard	banhart
anathomy	anatomy
juszin	justin
galayx	galaxy
quidditsch	quidditch
completley	completely
sigacikta	sigacik
sclucken	schlucken
lippspringen	lippspringe
nordenstat	nordenstadt
lifetab®	lifetab
teeemo	teemo
rememeber	remember
autotrader.	autotrader
eispung	eisprung
osteria,	osteria
klagender	klagende
expensives	expensive
wundem	wunden
krausem	krauses
yenikentte	yenikent
pornstat	pornstar
marvel´s	marvel's
blasenentzündun	blasenentzündung
ssassins	assassins
freiluftkinos	freiluftkino
tdbgrid	dbgrid
blasenentzuendung	blasenentzündung
bojangels	bojangles
easynot	easynote
1.zyklus	zyklus
coretm	core™
alterunterschied	altersunterschied
askerlikte	askerlik
skaufen	kaufen
rassieren	rasieren
cruible	crucible
lavignes	lavigne
remant	remnant
82801db(m)	82801dbm
pornstrar	pornstar
idaacada	idaacadda
nautilis	nautilus
dishonoured	dishonored
unwiederruflich	unwiderruflich
mannliche	männliche
lcomania	icomania
schäbens	schaebens
atakumda	atakum
adjectival	adjective
ultrabooktm	ultrabook
heads:	heads
laengste	längste
kosennamen	kosenamen
ashampoo®	ashampoo
sniper:	sniper
fujifilm,	fujifilm
eisprung,	eisprung
kha`zix	kha'zix
standallone	standalone
haemocult	hämoccult
harnrohre	harnröhre
kurzhhaarfrisuren	kurzhaarfrisuren
johansson,	johansson
gelexy	galaxy
carvern	carver
bernada	bernarda
yourseld	yourself
pornstard	pornstars
dailay	daily
withern	wither
zervikalschleim	zervixschleim
mutakil	mustakil
strave	starve
gnubbel	knubbel
jennife	jennifer
weitzenboeck	weitzenböck
www.nicklodeon	www.nickelodeon
karottenoel	karottenöl
kalburabastı	kalburabasti
selena.	selena
miteten	mieten
antiandrogenen	antiandrogene
dünnerer	dünner
wohnjngen	wohnung
nowosti.	novosti
kontake	kontakte
labaracca	baracca
fuckin	fucking
celluite	cellulite
kurzhaarfrisur,	kurzhaarfrisuren
manson's	manson
seibai	seibai!
erkàltung	erkältung
nyhira	nhyira
springsteens	springsteen
stilik	satilik
drachenprister	drachenpriester
kurzhaarfrusuren	kurzhaarfrisuren
wreking	wrecking
mocambik	mosambik
speicher.	speicher
diection	direction
fallout:	fallout
yukseleni	yükseleni
birandin	birand
sporske	sportske
cucuo	cuoco
sumpflilien	sumpflilie
tulisa's	tulisa
galyxy	galaxy
pastéis	pasteis
oelige	fettige
hallscher	hallescher
schwamger	schwanger
stilistic	stylistic
umutsus	umutsuz
brautfriuren	brautfrisuren
pasticiera	pasticcera
vampirjaeger	vampirjäger
noordzee,	noordzee
ausflusd	ausfluss
rizzolie	rizzoli
sparticus	spartacus
scheidr	scheide
freistell	freistellen
akkrode	akkorde
gallactica	galactica
breakind	breaking
hewitt's	hewitt
weisheitszahnop	weisheitszahn
natilus	nautilus
colliens	collien
chirstmas	christmas
schnerzen	schmerzen
heatherway	hathaway
revist	revista
schwangerschaftest	schwangerschaftstest
hotest	hottest
raffaëla	raffaela
menhunt	manhunt
swanepoels	swanepoel
blutubg	blutung
alkoholfreien	alkoholfreier
tained	tainted
ciftlikköyde	ciftlikköy
eminem's	eminem
chrstmas	christmas
ubunutu	ubuntu
trotzphasen	trotzphase
argumentativ	argumentative
snokki	snooki
aufluss	ausfluss
aorund	around
gefroce	geforce
bitsize	bitesize
smeels	smells
silvershampoo	silbershampoo
blasenentzündund	blasenentzündung
injustice:	injustice
streifenfreie	streifenfrei
springstee	springsteen
scrrenshot	screenshot
tenacoius	tenacious
lippenbaendchen	lippenbändchen
awakining	awakening
chmapions	champions
gelartiger	geleeartiger
maceau	marceau
crolls	scrolls
therone	theron
mibafire	mobafire
bootsektoren	bootsektor
schwanget	schwanger
derivant	deviant
bosnischem	bosnischen
skyfalls	skyfall
silikonfreien	silikonfreie
erorische	erotische
awekening	awakening
fragenzeichen	fragezeichen
impossibe	impossible
androod	android
sahdes	shades
curcible	crucible
folsaure	folsäure
boethiahs	boethias
rowland)	rowland
arkward	awkward
neather	nether
weisheitszahne	weisheitszähne
weathere	weather
poisel,	poisel
mither	mother
baumgarnter	baumgartner
pretiest	sexiest
2602hw	2602hwn
fteund	freund
biel's	biel
lyricfs	lyrics
mpbafire	mobafire
huntingten	huntington
100dors	100doors
woodkit	woodkid
houston:	houston
pandaria]	pandaria
layto	layton
pillenpause,	pillenpause
houston's	houston
nigga's	niggas
dierection	direction
celebriy	celebrity
kunefe	künefe
shinjiteru!	shinjiteru
orriere	corriere
macauly	macaulay
jutarnje	jutarnji
mlchael	michael
niticias	noticias
steinboch	steinbock
twelth	twelfth
schatten!	schatten
kaloriem	kalorien
loncle	l'oncle
schlugauf	schluckauf
katness	katniss
friseru	friseur
üzerli	uzerli
çorbasi	corbasi
achwanger	schwanger
schuppenflecht	schuppenflechte
afterfall:	afterfall
trinity:	trinity
übertaktungs	übertakten
sheppards	shepherds
gosling,	gosling
großporiger	großporige
woopies	woobies
whalberg	wahlberg
tecture	texture
schnwanger	schwanger
brustvergrößerungs	brustvergrößerung
univga	univga3
impfung,	impfung
dchwanger	schwanger
erol'un	erolun
abfuehrend	abführend
editoren	editor
ikolatal	cikolatali
l'thyroxin	thyroxin
ploetzlicher	plötzlicher
3.monate	monate
lawleys	lawley
camoren	cameron
repiblic	republic
bllons	bloons
portmans	portman
jackosn	jackson
martinsgeschichten	martinsgeschichte
eheähnlichem	eheähnliches
befridiegen	befriedigen
costner's	costner
tûrkiye	türkiye
desperates	desperate
trihft	thrift
diaies	diaries
(cedric	cedric
gilfsfinishingthejob	girlsfinishingthejob
drunkemöller	drunkenmölle
viramin	vitamin
anguilera	aguilera
schleimpropf	schleimpfropf
deniz'in	denizin
ue40es5700s	ue40es5700
cerazett	cerazette
auriel's	auriels
l'orchidea	orchidea
chöner	schöner
lxyrics	lyrics
michelin.	michelin
mobafira	mobafire
gemerkt,	gemerkt
assassns	assassins
augenbrauchen	augenbrauen
errotische	erotische
celebrtiy	celebrity
méridien	meridien
luzumsuz	lüzumsuz
porntar	pornstar
axelschweiß	achselschweiß
miwten	mieten
klum's	klum
cihangirde	cihangir
schords	chords
psychosexuellen	psychosexuelle
freundeskrei	freundeskreis
dunyasindan	dünyasindan
jeztztspielen	jetztspielen
durchnehme	durchnehmen
celebirty	celebrity
đungla	dzungla
ringe:	ringe
weatherin	weather
relevations	revelations
mobiafire	mobafire
turgutreiste	turgutreis
lesgue	league
gefaehrlichste	gefährlichste
cosgroves	cosgrove
bullok	bullock
beneth	beneath
spingsteen	springsteen
unsimulatet	unsimulated
sschwanger	schwanger
justun	justin
mittelohrentzundung	mittelohrentzündung
jemason	jameson
brookly	brooklyn
koftesi	köftesi
hueriyet	hürriyet
frisuen	frisuren
bundesliage	bundesliga
raspbery	raspberry
kamasutara	kamasutra
goulding,	goulding
noticiasde	noticias
sawatzki,	sawatzki
jungfrau,	jungfrau
currencey	currency
steinkamps	steinkamp
luminiers	lumineers
fesplatte	festplatte
lawrence:	lawrence
peroide	periode
haarkuren	haarkur
whithin	within
schamlippem	schamlippen
otgasmus	orgasmus
direcction	direction
weatther	weather
whatsapo	whatsapp
kontaktspeere	kontaktsperre
pornstats	pornstars
dickerer	dicker
armagedom	armageddon
abseten	absetzen
terraia	terraria
arnavutköyde	arnavutköy
vadidi	vadisi
authorisieren	autorisieren
playbiy	playboy
mustakıl	mustakil
macbokk	macbook
scheide,	scheide
kurzhaare	kurzhaar
friduren	frisuren
beautifl	beautiful
ich7m/u	ich8m
bobrisuren	frisuren
maxbook	macbook
radoen	radeon
macboook	macbook
anddroid	android
ekerpare	sekerpare
cucible	crucible
torschuetzenliste	torschützenliste
müller's	müller
steuerelements	steuerelement
orgasmuns	orgasmus
»intelia	intelia
wetteronline,	wetteronline
(laughing	laughing
karaburunda	karaburun
courtss	courts
gonez	gomez
miezten	mieten
festplattte	festplatte
komedi2	komedi
immobili8en	immobilien
quropeco	qurupeco
ludwig's	ludwig
k0stenlose	kostenlos
forecast,	forecast
geheimnissvolle	geheimnisvolle
kuruhaarfrisuren	kurzhaarfrisuren
hepburn's	hepburn
leacked	leaked
eautiful	beautiful
sandsturms	sandsturm
jacksin	jackson
lavgine	lavigne
hrones	thrones
waitung	waiting
şekerpare	sekerpare
donnerwetter.	donnerwetter
blasenenzuendung	blasenentzündung
animaler	animal
mosby's	mosby
kalirien	kalorien
diretion	direction
hükmet	hükümet
friday:	friday
durchzunehmen	durchnehmen
java.net.sockettimeoutexception:	java.net.sockettimeoutexception
eidechs	eidechse
stevies	stevie
shadow2	shadow
otávio	otavio
falında	falinda
bombenentschaerfung	bombenentschärfung
bekinizone	bikinizone
kaufan	kaufen
cucou	cuoco
humphrie	humphries
mrcrayfish's	mrcrayfish
mueten	mieten
montheith	monteith
glöschte	gelöschte
scheanger	schwanger
lavigne,	lavigne
rollong	rolling
influental	influential
drakensang,	drakensang
arcitc	arctic
windowx	windows
alptraume	alpträume
sproede	spröde
nierenbeckenentzuendung	nierenbeckenentzündung
würgreiz	würgereiz
soymanin	soyman
delicious:	delicious
choards	chords
gefilterten	gefilterte
transporter:	transporter
pattinsons	pattinson
r/pierced	pierced
kurzhaaartrends	kurzhaartrends
tulisas	tulisa
éditions	editions
athlon64	athlon
guuitar	guitar
warrior2	warrior
bigges	biggest
semilar	similar
agility3	agility
zengın	zengin
clcirbs	clicrbs
valdimir	vladimir
onlinet	online
conelly	connelly
schwangerschaftstreifen	schwangerschaftsstreifen
akalie	akali
feuchtigkeitsmasken	feuchtigkeitsmaske
oekolb	oekolp
kaminstuben	kaminstube
haven´t	haven't
findet,	findet
watson:	watson
kreisrundem	kreisrunder
zuckerbergs	zuckerberg
handtuchtrockenes	handtuchtrocken
lebowsky	lebowski
seaason	season
swanepole	swanepoel
shamppo	shampoo
monchspfeffer	mönchspfeffer
hangmans	hangman's
geofenimin	gofeminin
terrara	terraria
virtaul	virtual
yastin	justin
dragoncave	dragcave
godrics	godric's
posotions	positions
willimas	williams
verwohnen	verwöhnen
upten	upton
unterlein	unterleib
textrue	texture
terrria	terraria
tayloer	taylor
schwammkopfs	schwammkopf
schachtar	schachtjor
rfrisuren	frisuren
periodr	periode
nackte.	nackte
lawles	lawless
kngiht	knight
kaltwax	kaltwachs
jsutin	justin
gliniecke	glienicke
flueche	flüche
blassenentzündung	blasenentzündung
asphire	aspire
vergessen,	vergessen
hueften	hüften
sandalin	sandal
scharmlippe	schamlippe
tonight)	tonight
moafire	mobafire
cruise's	cruise
arnachy	anarchy
stähnchen	strähnchen
moabfire	mobafire
orgasnus	orgasmus
softonic.	softonic
twistet	twisted
j1mb0's	jimbos
esident	resident
jennider	jennifer
kkurzhaarschnitte	kurzhaarschnitte
weasley's	weasley
vibratot	vibrator
shipppuden	shippuuden
maranov	maranow
geisburger	gaisburger
(desire)	desire
stones,	stones
yukselen	yükselen
kournikowa	kournikova
çalikusu	calikusu
partiotion	partition
fruchtsaeurepeeling	fruchtsäurepeeling
möchspfeffer	mönchspfeffer
zerwixschleim	zervixschleim
hohepunkt	höhepunkt
sedaya	seda'ya
directon	direction
schanger	schwanger
eurosport.	eurosport
schwange	schwanger
kamekaze	kamikaze
akkusative	accusative
riesing	rising
vorrausichtliche	voraussichtliche
uebelriechender	übelriechender
//minecraft	minecraft
sharone	sharon
expactations	expectations
resdient	resident
aguilera:	aguilera
hootest	hottest
m.gofeminin.de	gofeminin.de
krathus	karthus
viatmin	vitamin
velevet	velvet
shippiden	shippuuden
fallling	falling
bradshow	bradshaw
beuatiful	beautiful
corriero	corriere
ziehem	ziehen
zusammenzufügen	zusammenfügen
weathr	weather
planescape:	planescape
dong!	dong
ovolationstest	ovulationstest
knutschflecke	knutschfleck
dellla	della
kurzhaarfisur	kurzhaarfrisur
hutzinger	hunziker
schleimfropf	schleimpfropf
schwangerschafstest	schwangerschaftstest
kravits	kravitz
seaosn	season
trennkoste	trennkost
sgalaxy	galaxy
freundinn	freundin
espárragos	esparragos
maccurdy	mccurdy
degenres	degeneres
justiin	justin
infnity	infinity
masteryi	master
gullerin	güllerin
wharsapp	whatsapp
parmiggiana	parmigiana
kokosol	kokosöl
terraraia	terraria
etimesgutta	etimesgut
clinton's	clinton
chatterlay	chatterley
bootfähiger	bootfähigen
kurhaarschnitte	kurzhaarschnitt
a.akamaihd.ne	a.akamaihd.net
susanoğlunda	susanoglunda
sempedro	sampedro
saeuberung	säuberung
sümela'nin	sümelanin
wheater	weather
schwangerschaftsablauf	schwangerschaftsverlauf
teebaumol	teebaumöl
mobaifre	mobafire
kaiserreiches]	kaiserreiches
viamin	vitamin
genitaler	genital
nothng	nothing
eßkastanien	esskastanien
pammela	pamela
guevaras	guevara
carerre	carrere
wispered	whispered
symphaty	sympathy
barrymor	barrymore
shippude	shippuuden
pomplum	pomplun
güzelobada	güzeloba
frnkfurter	frankfurter
skyword	skyward
tekkti	tekkit
angehalten.	angehalten
valesquez	velasquez
angel´s	angels
eissprung	eisprung
sokalar	sokaklar
theyve	they've
schreckensvorstoss	schreckensvorstoß
konfigurationsprofile	konfigurationsprofil
chismas	christmas
seasonl	season
hotchkin	hodgkin
marktkaffee	marktcafe
hähnchenbrüste	hähnchenbrust
übelkeiten	übelkeit
timbelake	timberlake
slyvie	sylvie
wminecraft	minecraft
bleeching	bleaching
tube,you	tubeyou
gesundesten	gesündesten
cytalopram	citalopram
octomoms	octomom
betaubung	betäubung
erregierter	erigierter
indizierten	indizierte
lyrcics	lyrics
allisport	allisports
devlopers	developers
gaseta	gazeta
perect	perfect
cooming	coming
ultimatr	ultimate
bindehautentzundung	bindehautentzündung
androis	android
milchigen	milchiger
verdreh	verdrehe
textverarbeitungs	textverarbeitung
doran's	dorans
barlow's	barlow
cocaines	cocaine
schirtless	shirtless
gosssip	gossip
svhnell	schnell
liars:	liars
Übelkeit	übelkeit
mynnet	mynet
gesündestes	gesündeste
murdered:	murdered
iconomania	icomania
morissett	morissette
freundind	freundin
heavon	heaven
thunderbold	thunderbolt
jannifer	jennifer
haberlerini	haberleri
sogliole	sogliola
gestuftem	gestufter
gangname	gangnam
schöener	schöner
ivanca	ivancan
daviant	deviant
watchmen:	watchmen
mobafie	mobafire
nüchternwerte	nüchternwert
spartacu	spartacus
flanes	flan's
eigentusmwohnung	eigentumswohnung
sümela'nın	sümelanin
littlie	little
riffkraken	riffkrake
paltrow's	paltrow
solomod	solomid
whenever,	whenever
galatasatay	galatasaray
erotosche	erotische
chappele	chappelle
mutterpaß	mutterpass
scueler	schüler
ultumate	ultimate
ip3000x	ip3000
cottilard	cotillard
barnefeld	barneveld
faltmarkierungen	faltmarkierung
erikah	erykah
ericsso	ericsson
iconmania	icomania
cuurency	currency
connectivität	konnektivität
ahrabia	ahrabian
kaiserlachse	kaiserlachs
bitzkit	bizkit
zahneputzen	zähneputzen
magazone	magazine
otesiz	ötesiz
felgeburt	fehlgeburt
gursky,	gursky
absulotion	absolution
thorne's	thorne
onalin	online
notbush	nutbush
lesabian	lesbian
kaloriene	kalorien
pepige	peppige
wondewall	wonderwall
seborrhoischer	seborrhoische
schanlippen	schamlippen
haarfuelle	haarfülle
dictionary.	dictionary
trilium	trillium
kaufeen	kaufen
www.monzter	www.monster
mavericks,	mavericks
karueche	karrueche
dammriß	dammriss
freubd	freund
n2gether	gether
motherfukin	motherfucking
gaziante	gaziantep
explorere	explorer
kkaufen	kaufen
puredbcraft	purebdcraft
antoher	another
evil:	evil
witcher:	witcher
wiewowas	wuewowas
pitchfork's	pitchfork
curible	crucible
kamustra	kamasutra
mosnters	monsters
lovati	lovato
cruzify	crucify
patraeus	petraeus
superman:	superman
pamala	pamela
roteln	röteln
m.scheuermann	scheuermann
forces:	forces
impssible	impossible
currrency	currency
geblassen	geblasen
einstien	einstein
unterleid	unterleib
́onore	l'onore
medicus,	medicus
reachest	richest
shyvanna	shyvana
spinnbaren	spinnbarer
ungeschmickt	ungeschminkt
tonkins	tonkin
sanatarium	sanitarium
çiftlikköyde	çiftlikköy
jüstin	justin
wechselobjektiven	wechselobjektiv
androidn	android
unregelmäßigen	unregelmäßigem
twichtch	twitch
schwangeschaftstest	schwangerschaftstest
freunfin	freundin
d’angelo	d'angelo
wohlung	wohnung
penelop	penelope
eilleiter	eileiter
partitition	partition
ozcivit	özcivit
tarantinos	tarantino
ueberreden	überreden
tubulärer	tubuläre
meagon	meagan
blutgeister	blutgeist
courious	curious
^wohnung	wohnung
weaslys	weasley
pasdiert	passiert
tespih	tesbih
anciente	ancient
abgewohnen	abgewöhnen
vkotakte.ru	vkontakte.ru
mullholland	mulholland
urfaliyim	urfaliyam
jilvans	jilvan
derulos	derulo
www.jezt	www.jetzt
hiren’s	hiren's
mumfort	mumford
sturmovik:	sturmovik
mittelerde:	mittelerde
huaweis	huawei
umdum	umudum
himbeerblaettertee	himbeerblättertee
entchant	enchant
bleigiesen	bleigießen
yüzyila	yüzyil
wohnubg	wohnung
akkulaufzeiten	akkulaufzeit
onlines	online
braeking	breaking
aguilara	aguilera
erkennnt	erkennt
vermächtniss	vermächtnis
valetines	valentines
citalpram	citalopram
zeiterfassungs	zeiterfassung
ultomate	ultimate
intinbereich	intimbereich
nbenwirkungen	nebenwirkungen
dünyasından	dünyasindan
l´wren	l'wren
spießerei	spiesserei
dalaxy	galaxy
valentinstags	valentinstag
soroity	sorority
memroy	memory
gazzzetta	gazzetta
globo.	globo
youngol	yaungol
macaronni	macaroni
reccount	recount
merriem	merriam
erektiler	erektile
bilderkombo	bildkombo
dehnungstreifen	dehnungsstreifen
besenreißer	besenreiser
harndran	harndrang
antragsformulars	antragformulars
pollicke	policke
grieisches	griechisches
apache:	apache
weahter	weather
emultor	emulator
scmeckt	schmeckt
oliver's	oliver
zornesfalten	zornesfalte
cuoko	cuoco
pannetiere	panettiere
crispie	crispy
anndroid	android
rohanna	rihanna
kämmers	kämmerers
rassiere	rasiere
paltrows	paltrow
.numbers	numbers
sushilicious	sushileecious
oodgame	goodgame
geschicjten	geschichten
cocker,	cocker
samsungs	samsung
revenge:	revenge
balsenentzündung	blasenentzündung
verhaelt	verhält
yesilkentte	yesilkent
talgdruesen	talgdrüsen
stadfeld	stadtfeld
empires:	empires
desitvforums	desitvforum
kausfen	kaufen
destenys	destiny's
gozlerimde	gözlerimde
dreamer,	dreamer
dunyam	dünyam
lebeouf	labeouf
kakufen	kaufen
gedecktem	gedeckt
erotidche	erotische
weisheitszaehne	weisheitszähne
frisusen	frisuren
häslein	häschen
mountian	mountain
jojovich	jovovich
ka’roz	ka'roz
goveneur	governor
screamshot	screenshot
wilkenson	wilkinson
swalloed	swallowed
persembede	persembe
celibrity	celebrity
betrogen,	betrogen
sharapova's	sharapova
kurhaar	kurzhaar
frisruen	frisuren
leafue	league
ultimste	ultimate
verdienende	verdiente
iconmenia	icomania
macbbok	macbook
gripostat	grippostad
tatooed	tattooed
polyzystischen	polyzystische
horosocpe	horoscope
kreisrunden	kreisrunder
malchor's	malchors
dauerts	dauert
brullee	brulee
advenutre	adventure
dakİka	dakika
ubuntuu	ubuntu
pocket.	pocket
gernerals	generals
chordes	chords
binomischen	binomische
kimgdom	kingdom
terarria	terraria
ebesten	besten
arnavutkoyde	arnavutköyde
ulitmate	ultimate
mornign	morning
ukdaily	daily
kiss:	kiss
morrisette	morissette
dailyy	daily
leutfeuer	leuchtfeuer
ledgends	legends
frauenarzr	frauenarzt
brokem	broken
arthut	arthur
stewardt	stewart
silberschampoo	silbershampoo
chords.	chords
frisoren	frisuren
mercury's	mercury
dhanik	dainik
untetleib	unterleib
satılk	satılık
prenslauer	prenzlauer
haberturktv	haberturk
wilfire	wildfire
willliams	williams
j1mb0s	j1mb0's
demnachst	demnächst
grey´s	grey's
aelteren	älteren
nuvoring	nuvaring
mottowochen	mottowoche
sellungen	stellungen
galaxcy	galaxy
assymetrischer	asymmetrischer
mackenzi	mackenzie
rillige	wellige
theroy	theory
raindeer	reindeer
fleetwod	fleetwood
efinacial	efinancial
loveee	loveeee
routenplaner,	routenplaner
kirşehir	kirsehir
desbarado	desperados
solitiare	solitaire
lommond	lomond
cemetries	cemeteries
eliminacji	eliminacje
kaiserschnitt,	kaiserschnitt
schleimpropfen	schleimpfropf
trnnkost	trennkost
cdating	dating
zaoh	zhao
kaynarcada	kaynarca
scläft	schläft
unalmis	ünalmis
komponiere	komponiert
schwangerschaft.	schwangerschaft
giginox	gigginox
riemanns	riemann
crcket	cricket
asassins	assassins
özçivit	özcivit
waitng	waiting
nachname,	nachname
m,ieten	mieten
hutsman	huntsman
baglumda	baglum
duellist	duelist
kindgom	kingdom
mobfaire	mobafire
celebrty	celebrity
slep.com	slap.com
roberston	robertson
thaumcraft3	thaumcraft
revovery	recovery
stweart	stewart
ltimate	ultimate
zurückgelassene	zurückgelassener
sndroid	android
vespine	vespinen
laengster	längster
eregende	erregende
toenung	tönung
verkleidungsidee	verkleidungsideen
fergie,	fergie
stimmuliert	stimuliert
destynis	destiny's
ortaköyde	ortaköy
cuoci	cuoco
7.monate	monate
interior.	interior
belluci	bellucci
tesselate	tessellate
wheather	weather
mietwn	mieten
madrıd	madrid
i8mmobilien	immobilien
novoring	nuvaring
eisprunges	eisprungs
regelschmerz	regelschmerzen
cucoco	cuoco
antiviruses	antivirus
0x00007e	0x0000007e
cebimdeki	cebimde
assassians	assassins
wachsne	wachsen
cm8738	cmi8738
grafenwoehr,	grafenwoehr
emell's	emells
pcific	pacific
mieteohnungen	mietwohnungen
streßtest	stresstest
rasieren,	rasieren
haberkeri	haberleri
glaeschen	gläschen
haaraufall	haarausfall
d'5100	d5100
citalophram	citalopram
darmwurm	bandwurm
responsiv	responsive
lohenruten	lohenrute
chords7	chords
pikmentflecken	pigmentflecken
tattoed	tattooed
sadilik	satilik
shedes	shades
trainer!	trainer
jistin	justin
misotoe	mistletoe
goodgae	goodgame
chalize	charlize
plotzlicher	plötzlicher
dorkley	dorkly
enseño	enseno
çolpan	colpan
gefarbt	gefärbt
schweisdrüsen	schweißdrüsen
parttion	partition
freucht	feucht
trömso	tromso
ratjakowski	ratajkowski
comerico	comercio
hildman	hildmann
netzbetrieb,	netzbetrieb
gebarmutter	gebärmutter
duslerde	düslerde
charliz	charlize
beliebtestens	beliebtesten
rihanan	rihanna
skargard	skarsgard
ravenclaws	ravenclaw
mubascher	mubasher
kackson	jackson
curamed®	curamed
civrilde	civril
comedys	comedy
eingerissenen	eingerissene
statusse	status
fiddel	fiddle
anachry	anarchy
andtoid	android
abteibung	abtreibung
tigether	together
oloughlin	o'loughlin
gazzettta	gazzetta
vampre	vampire
intikan	intikam
wphnung	wohnung
jungfra	jungfrau
buble's	buble
itembuilt	itembuild
coochi	coochie
baisier	baiser
haemoccult	hämoccult
holidae	holiday
imgine	imagine
celeprity	celebrity
catrell	cattrall
rocznic	rocznica
vergesseb	vergessen
fetsplatte	festplatte
destiny´s	destinys
schwanger.	schwanger
harverst	harvest
courntey	courtney
roetungen	rötungen
kÖrperwelten	körperwelten
junfernhäutchen	jungfernhäutchen
gangmam	gangnam
zauberdrachen	zauberdrache
msfw	nsfw
glaslight	gaslight
sonething	something
karayilanin	karayilan
empite	empire
mobaire	mobafire
benath	beneath
caitikische	caitikirsche
kündigungsausschluß	kündigungsausschluss
benifica	benfica
wimmobilien	immobilien
peeiode	periode
beziehubg	beziehung
affleck's	affleck
́connor	connor
e:signature	signature
karenia	karenina
kardialen	kardiale
chsing	chasing
bounching	bouncing
angelese	angeles
anatmy	anatomy
assasssins	assassins
schwangerschatstest	schwangerschaftstest
empires2	empires
nvidida	nvidia
ako.	ako
dokumentschutz	dokumentenschutz
wareframe	warframe
hausksuf	hauskauf
galaxs	galaxy
pyolisin	pyolysin
schlosscafé	schlosscafe
phrasel	phrasal
vmpire	vampire
dstiny	destiny
assassins's	assassins
bolognes	bolognese
ultimte	ultimate
reverenge	revenge
pornstas	pornstars
androud	android
scnecke	schnecke
wohnunh	wohnung
solomdi	solomid
leagoe	league
chords:	chords
furoius	furious
cuaco	cuoco
osnabruck,	osnabrück,
monroe's	monroe
staphylokokkus	staphylococcus
potter,	potter
shoener	schöner
einsprung	eisprung
lifehous	lifehouse
beschäftigunsverbot	beschäftigungsverbot
celullite	cellulite
andoird	android
venegeance	vengeance
infintie	infinite
blasenenzundung	blasenentzündung
a.akamaihd.	a.akamaihd
californicaton	californication
corroe	correo
sodbrenne	sodbrennen
wohbung	wohnung
rasperry	raspberry
littlr	little
ahibinden	sahibinden
kindercafes	kindercafe
gleday	gledai
kalmanın	kalmanin
tongiht	tonight
assassisn	assassins
leggigs	leggings
analvenenthrombosen	analvenenthrombose
tenicious	tenacious
whiteny	whitney
sexret	secret
lüdwigsfeld	ludwigsfeld
haenging	hanging
emily`s	emily's
bluered	blurred
lyrivcs	lyrics
ungeschützer	ungeschützter
akyakada	akyaka
mkaufen	kaufen
accidential	accidental
dublicates	duplicates
correire	corriere
färben,	färben
digitalkamera.	digitalkamera
fırefox	firefox
haesslichste	hässlichste
mutti.	mutti
posision	position
horoskope,	horoskope
acrion	action
snowden's	snowden
lindsa	lindsay
çarşambada	çarşamba
keynot	keynote
celebrety	celebrity
monsterhigh.	monsterhigh
cyurus	cyrus
tampong	tampon
kickoff!!	kickoff
proststa	prostata
blasenentzündug	blasenentzündung
mutermund	muttermund
piazza,	piazza
leliana's	lelianas
daylimotion:	dailymotion
satillik	satilik
eisentatzmarken	eisentatzmarke
rosenfarbe	rosenfarben
wallking	walking
gwichtszunahme	gewichtszunahme
salamie	salami
bauchspieglung	bauchspiegelung
giardiose	giardien
persia:	persia
geplatze	geplatzte
schwangerschaftsteste	schwangerschaftstest
abnehmen.	abnehmen
hØr	hør
ônline	online
kompabilit	kompatibilit
freundiin	freundin
somatoformen	somatoforme
İkinci	ikinci
nördlichstes	nördlichste
immobiluen	immobilien
conecticut	connecticut
r/handjob	handjob
malasyia	malaysia
majestaet	majestät
symphonia:	symphonia
5007eg	ar5007eg
mabafire	mobafire
salbeibonbon	salbeibonbons
güzelçamlıda	güzelçamlı
ganganm	gangnam
cardashian	kardashian
ceracette	cerazette
argentos	argento
celebraty	celebrity
xounter	counter
trödelmakrt	trödelmarkt
mockinbird	mockingbird
cortim	cotrim
bartholin's	bartholin
fuhlt	fühlt
who´ll	who'll
totilla	tortilla
kondom,	kondom
seasom	season
hâuser	häuser
malikes	malike's
restauerant	restaurant
krises	crisis
cengelköyde	cengelköy
ofthrones	thrones
ledgend	legend
akoorde	akkorde
gefuehl	gefühl
gamepro.	gamepro
kocyiyit	kocyigit
maynet	mynet
gefärbt,	gefärbt
samsubg	samsung
inhaltssteuerelemente	inhaltssteuerelement
halblangem	halblanges
adventre	adventure
nocture	nocturne
hellrotem	hellrotes
jurrassic	jurassic
jin'ya,	jin'ya
iconamia	icomania
kurzhaarfrisue	kurzhaarfrisur
www.monsterhei	www.monsterhigh
kalorieren	kalorien
jacksom	jackson
timberlak	timberlake
piazetta	piazzetta
ininite	infinite
batikentte	batikent
appelgate	applegate
neustedter	neustädter
auge:	auge
devandra	devendra
crépes	crepes
keynan	k'naan
marvel:	marvel
trömsö	tromsö
southpark.	southpark
sheogoraths	sheogorath
kalorinarme	kalorienarme
irreplacable	irreplaceable
abnehnen	abnehmen
statham,	statham
schwangerschaftsstest	schwangerschaftstest
woltmershause	woltmershausen
sumelanin	sümelanin
zurückgesetzt,	zurückgesetzt
solaruim	solarium
gelnagel	gelnägel
ancillia	ancilla
textue	texture
equestia	equestria
eigetumswonung	eigentumswohnung
tennenbaums	tenenbaums
magazine's	magazine
blattgruen	blattgrün
benater	benatar
clancys	clancy's
ideacentre®	ideacentre
forte®	forte
ciftlikkoy	ciftlikköy
wohnumg	wohnung
sarımsaklıda	sarımsaklı
befridigen	befriedigen
kinlde	kindle
christmad	christmas
silvermann	silverman
festsitzendem	festsitzender
umbenenn	umbenennen
friendszone	friendzone
schweighoefer	schweighöfer
chocoloate	chocolate
hautverjüngungs	hautverjüngung
racing3	racing
supernarural	supernatural
angelique:	angelique
schwnger	schwanger
helvası	helvasi
manager13	manager
magersuechtig	magersüchtig
emily´s	emily's
olympu	olympus
fusszeile	fußzeile
epiliren	epilieren
eigrntumswohnung	eigentumswohnung
administartor	administrator
s.a.l.e	s.a.l.e.
zamnki	zamanki
cartón	cartón
torilla	tortilla
schmierbltung	schmierblutung
inzuma	inazuma
darmverschlu	darmverschluß
omerta:	omerta
schreiphasen	schreiphase
tacabron	cabron
downten	downton
satilk	satilik
assssins	assassins
hohzoll	hochzoll
haslamasi	haslama
cansizin	cansiz
baldiger	baldige
phimosen	phimose
schlaft	schläft
taindet	tainted
modesche	modische
impossilbe	impossible
perdiode	periode
ateşini	atesini
senkfüße	senkfuß
schwangr	schwanger
insura=40	insurance
vitamn	vitamin
lefloids	lefloid
partiton	partition
teuerst	teuerste
laetita	laetitia
macklemore's	macklemore
erdten	ersten
wasent	wasn't
çilekli	cilekli
halleluiah	hallelujah
whereever	wherever
lowrence	lawrence
medinight	medinait
presley:	presley
urgott	urgot
sichelfüße	sichelfuß
exteren	externe
beatuiful	beautiful
sparknote	sparknotes
wojhnung	wohnung
unützes	unnützes
telecinco.	telecinco
jahide	cahide
bäucherchen	bäuerchen
awakeing	awakening
ausflusss	ausfluss
m.united	united
anderon	anderson
cataclyst	catalyst
uptom	upton
kaufeni	kaufen
tahminkollik	tahminkolik
parkcafé	parkcafe
darbaar	darbar
angilina	angelina
baricades	barricades
max:	max
kanonensteppel	kanonesteppel
barbie.	barbie
triebseer	tribseer
wollowitz	wolowitz
america2	america
schwangee	schwanger
kurzharrfrisur	kurzhaarfrisuren
revocery	recovery
lynettes	lynette
alchemist:	alchemist
cosgrov	cosgrove
formatierungen	formatierung
nadelpilz	nadelpilze
entchanted	enchanted
strahnen	strähnen
jutsin	justin
mobafore	mobafire
meieten	mieten
húrriyet	hürriyet
harnroehre	harnröhre
0lympus	olympus
oticias	noticias
kıymetler	kiymetler
frisuren.de.	frisuren.de
abgepumpter	abgepumpte
morrsion	morrison
ungluecklich	unglücklich
tatlıse	tatlises
fanatasy	fantasy
warriors2	warriors
lyfrics	lyrics
himmbeerblättertee	himbeerblättertee
wohnugn	wohnung
loyrics	lyrics
caracterization	characterization
cruicible	crucible
trennkosten	trennkost
barbi.	barbie
gefore	geforce
flugbeobachtungen	flugbeobachtung
vorraussichtliche	voraussichtliche
nebenwirkungne	nebenwirkungen
lifesafer	lifesaver
emulatur	emulator
demons,	demons
acrtess	actress
stueckwerk	stückwerk
wohnungeh	wohnung
erotischte	erotische
migrenin	migren
magaine	magazine
devinat	deviant
weihnachtsplätzen	weihnachtsplätzchen
wetetr	wetter
alacatida	alacati
cocou	cuoco
geldoff	geldof
0x00007b	0x0000007b
dargons	dragons
passenge	passenger
lovesomgs	lovesongs
nilüferde	nilüfer
lytrics	lyrics
ackless	ackles
yengeç	yengec
assasins	assassins
revival:	revival
garmaschen	gamaschen
drachenzahmen	drachenzähmen
whitcher	witcher
eurosport,	eurosport
unthetered	untethered
biggst	biggest
seaspn	season
scheidenpliz	scheidenpilz
sytra	sutra
schumann's	schumanns
mi9necraft	minecraft
fundementals	fundamentals
eisprung.	eisprung
dadario	daddario
einistung	einnistung
imtimbereich	intimbereich
middletons	middleton
fntasy	fantasy
zimemr	zimmer
abgewoehnen	abgewöhnen
cookiness	cockiness
witherspoon's	witherspoon
hilton.	hilton
bauspeicheldrüsenkrebs	bauchspeicheldrüsenkrebs
weaked	wicked
haarefrisuren	haarfrisuren
niçoise	nicoise
havuçlu	havuclu
baumgartner's	baumgartner
bayraklida	bayrakli
geronimos	geronimo's
unterstrichenen	unterstrichene
aschregen	ascheregen
narzistischen	narzisstischen
gunlerim	günlerim
streamrtl	streaming
micheline	michelin
yugiyo	yugioh
kenobis	kenobi
androiud	android
pentium®	pentium
kiselerde	kieselerde
aldırmayan	aldirmayan
dikilide	dikili
phenom2	phenom
universum:	universum
trôdelmarkt	trödelmarkt
eusprung	eisprung
pigmentflecke	pigmentflecken
biebee	bieber
glourious	glorious
celebbrity	celebrity
diarie	diaries
cumberbatch,	cumberbatch
reicheste	reichste
dailumotion	dailymotion
seasin	season
commmand	command
brooklyn’s	brooklyn's
christmans	christmas
blingen)	blingen
çelikkol	celikkol
währrend	während
mietspiegle	mietspiegel
schmerzloseste	schmerzloser
freundun	freundin
kiddin	kidding
vageina	vagina
skrolls	scrolls
porniseiten	pornoseiten
pikemon	pokemon
narnia:	narnia
maountain	mountain
eingelaufenen	eingelaufener
doflamingos	doflamingo
dankrsn	dankersen
befreidigen	befriedigen
grandmasters	grandmaster
haaroel	haaröl
eerotische	erotische
jkaufen	kaufen
stockhouse,	stockhouse
rollimg	rolling
oubliez	n'oubliez
schatten,	schatten
amalgin	avmalgin
yalcinin	yalcin
unterlaib	unterleib
gluecklich	glücklich
schwagnerschaft	schwangerschaft
ultiate	ultimate
ausflus	ausfluss
sutraa	sutra
occulus	oculus
qouotes	quotes
milcheinschuß	milcheinschuss
muskelentspannungs	muskelentspannung
catfigt	catfight
bobfriseuren	bobfrisuren
taskleite	taskleiste
schweissgeruch	schweißgeruch
ceylans	ceylan
karnında	karninda
visualizers	visualizer
akkordde	akkorde
müslum	müslüm
gefuhl	gefühl
hepburne	hepburn
imōto	imouto
endertruhen	endertruhe
azelea	azalea
jetztspiele.	jetztspielen
mobadire	mobafire
ruhanna	rihanna
pormstars	pornstars
m.vk.ru	vk.ru
igentumswohnung	eigentumswohnung
thunderboldt	thunderbolt
ubunte	ubuntu
́wohnung	wohnung
dpeche	depeche
bloombrg	bloomberg
poenstars	pornstars
mderne	moderne
plattenläden	plattenladen
petiode	periode
agarest:	agarest
terreria	terraria
optifinde	optifine
somerholder	somerhalder
tomtoes	tomatoes
emulaor	emulator
wohmung	wohnung
medcezirin	medcezir
freumd	freund
kurzhaarfrosuren	kurzhaarfrisur
cyeus	cyrus
telencinco	telecinco
lovestoned/i	lovestoned
verkurzt	verkürzt
théret	theret
ar5005gs	ar5005g
hunted:	hunted
lgends	legends
kardeshians	kardashian
panzer:	panzer
schoenhauser	schönhauser
hÜkÜmet	hükümet
fuhlsbuettler	fuhlsbüttler
asparaci	asparagi
erstaustattung	erstausstattung
stohnen	stöhnen
schammlippe	schamlippe
eregierter	erigierter
bilboard	billboard
surfer,	surfer
leía	leia
italinier	italiener
lesbina	lesbian
lesbisn	lesbian
cellolite	cellulite
/enchant	enchant
exploerer	explorer
radarwarn	radarwarner
xpreia	xperia
kazzoie	kazooie
residnet	resident
gleitgele	gleitgel
abdroid	android
krabeln	krabbeln
withput	without
émotifs	emotifs
schwannger	schwanger
pfeifferschen	pfeiffersches
nathional	national
murpheys	murphys
milano's	milano
intimbereich,	intimbereich
herals	herald
cubcakes	cupcakes
akward	awkward
wiederhergestellt.	wiederhergestellt
pasticciera	pasticcera
wwwkanal	www.kanal
claerblue	clearblue
5910dw	j5910dw
antiobiotika	antibiotika
beautifuk	beautiful
unchainend	unchained
.chi	chi
passowrt	passwort
hemsworth,	hemsworth
gossip.	gossip
bullock,	bullock
batıkentte	batıkent
bekomne	bekomme
grooping	groping
nyastin	nystatin
yakattacke!	yakattacke
optimu	optimus
riddlers	riddler
hasukauf	hauskauf
castlevania:	castlevania
r/chubby	chubby
süriyede	suriyede
glaetteisen	glätteisen
oeklesund	öklesund
herlad	herald
́angelo	angelo
erkenn	erkenne
portbale	portable
breiteres	breites
hawthrone	hawthorne
keague	league
c.thomas	thomas
ornaniert	onaniert
konnektivitaet	konnektivität
rapberry	raspberry
etektiv	detektiv
gerckes	gercke
angehalten,	angehalten
winfrey's	winfrey
ultimare	ultimate
haarmasken	haarmaske
nothig	nothing
gzzetta	gazzetta
destiny`s	destiny's
40k:	40k
beauriful	beautiful
entzuendungshemmende	entzündungshemmende
beautifol	beautiful
volkornnudeln	vollkornnudeln
ubtuntu	ubuntu
ungeschmink	ungeschminkt
galatadaray	galatasaray
asymetrische	asymmetrische
atletes	athletes
schamlipp	schamlippe
rawenclaw	ravenclaw
kinokritik	filmkritik
cyrzs	cyrus
mothet	mother
películas	peliculas
mieeten	mieten
leaalexas	leaalexa
wohnunb	wohnung
hochbruecke	hochbrücke
gebahrmutter	gebärmutter
bronchtis	bronchitis
brautfrisure	brautfrisuren
jelque	jelq
entharungscreme	enthaarungscreme
batman:	batman
maïlys	mailys
jessics	jessica
grasfleck	grasflecken
zapfchen	zäpfchen
securitz	security
solid:	solid
analverkeher	analverkehr
hazaron	hazaaron
vanguardi	vanguardia
timber!	timber
shppuden	shippuden
seitenabstände	seitenabstand
whattsapp	whatsapp
beschaeftigungsverbot	beschäftigungsverbot
austechen	ausstechen
xperie	xperia
oeriode	periode
etilerde	etiler
poweline	powerline
geisendorff.	geisendorff
betales	beatles
aol.9.0	aol9.0
macboo	macbook
aguilera,	aguilera
avesina	avecina
wimpernverlangerung	wimpernverlängerung
chords#	chords
aschenregen	ascheregen
uberreden	überreden
springfiel	springfield
macbool	macbook
bestverdienensten	bestverdienenste
kkurzhaarfrisuren	kurzhaarfrisuren
drankensang	drakensang
(rpc:s	[rpc:s
aan,	aan
virutal	virtual
bringsteen	springsteen
itembild	itembuild
geldofs	geldof
firewll	firewall
juatin	justin
gerueche	geruch
sesaon	season
www.hüriyet	www.hürriyet
zeilenumbrüche	zeilenumbruch
güzelcamlida	güzelcamli
drsgon	dragon
anston	aniston
stinkiger	stinkender
^skyrim	skyrim
hoeherer	höherer
stairways	stairway
kamakawiwoole	kamakawiwo'ole
vampirschwester	vampirschwestern
glücks]	glücks
geschixhten	geschichten
klum,	klum
blutung.	blutung
macklemor	macklemore
opimus	optimus
vampierjäger	vampirjäger
steibock	steinbock
schantall,	schantall
casiraghi,	casiraghi
schuppenflechten	schuppenflechte
dovizle	dövizli
warfigther	warfighter
seaaon	season
spears:	spears
querrille	querrillen
possibel	possible
seytape	sextape
conedy	comedy
stallones	stallone
spyro´s	spyro's
liztomania	lisztomania
altinolukta	altinoluk
novaring	nuvaring
dienstagsfrau	dienstagsfrauen
5.monate	monate
warnkros	warnkross
bornfire	bonfire
orcarina	ocarina
wohnhngen	wohnungen
qndroid	android
düssern	duissern
shugaring	sugaring
kamasutraa	kamasutra
tierherrschafts	tierherrschaft
ruhigster	ruhigste
seyfreid	seyfried
kopfhaut,	kopfhaut
firedrichshain	friedrichshain
schlafeb	schlafen
dropboxen	dropbox
weather,	weather
grande.	grande
risin	rising
christimas	christmas
filnstarts	filmstarts
trochene	trockene
jenesen	jensen
schaupsieler	schauspieler
lungenödeme	lungenödem
fertig!	fertig
kaloren	kalorien
gefaehrliche	gefährliche
duzyatan	düzyatan
destiniys	destiny's
oegasmus	orgasmus
panasonix	panasonic
heroes:	heroes
sarimsaklida	sarimsakli
winter’s	winter's
virtuelbox	virtualbox
lenghts	lengths
celebity	celebrity
schönstens	schönsten
notocias	noticias
nebenwirkungn	nebenwirkungen
kottbuser	kottbusser
posions	positions
rasiern	rasieren
springstenn	springsteen
batender	bartender
İlanlar	ilanlar
schwillen	schwellen
instict	instinct
untraschall	ultraschall
sokakalar	sokaklar
papiloten	papilotten
ordnergrösse	ordnergröße
nachteiler	nachteile
schmerzem	schmerzen
übermässiges	übermäßiges
suicude	suicide
vitamen	vitamin
rohbrach	rohrbach
garretts	garrett
eiweisswerte	eiweißwerte
champiosn	champions
maverics	mavericks
kurzhaarfrisure	kurzhaarfrisuren
albóndigas	albondigas
lattitude	latitude
shontell	shontelle
nebenwirkunge	nebenwirkungen
woodkind	woodkid
selbsbräuner	selbstbräuner
rasbery	raspberry
bopfrisuren	bobfrisuren
tangend	tangent
kennway	kenway
haarverlängerungen	haarverlängerung
blähung	blähungen
a.c.a.b.:	a.c.a.b.
wesley's	wesley
frisure	frisuren
lenos	leno
www.sächsiche	www.sächsische
viva.tv/	viva.tv
´wohnung	wohnung
utogest	utrogest
diesen,	diesen
frisuren.	frisuren
balotellis	balotelli
marleys	marley
schâfer	schäfer
zinktablette	zinktabletten
laufwer	laufwerk
wachphase	wachphasen
pointsteak	pointstreak
becker®	becker
steakhaus,	steakhaus
jazerra	jazeera
laopinion	opinion
wohnunt	wohnung
urfalıyam	urfaliyam
yuhioh	yugioh
naughti	naughty
mackbook	macbook
gouvener	governor
orinna	orianna
liberations	liberation
hanröhre	harnröhre
coutner	counter
fujifim	fujifilm
linday	lindsay
yuguoh	yugioh
yugiog	yugioh
whiters	withers
tmberlake	timberlake
pinklen	pinkeln
jailhous	jailhouse
biebber	bieber
assymetrische	asymmetrische
raid:	raid
hathaway's	hathaway
galaxys	galaxy
diesel's	diesel
govenor	governor
geischt	gesicht
michelín	michelin
kalkçaz	kalkcaz
lincol	lincoln
mietetn	mieten
winfreys	winfrey
cassie)	cassie
mmieten	mieten
2.ausbildung	ausbildung
versendete	gesendete
somebode	somebody
fetplatte	festplatte
greays	grey's
you´ve	you've
sidharta	siddhartha
fesrplatte	festplatte
nachtigallen	nachtigall
sattmachern	sattmacher
abendbreie	abendbrei
selcukta	selcuk
pancackes	pancakes
gaiden:	gaiden
gyllenhall	gyllenhaal
novocane	novacane
thomalla,	thomalla
dateine	dateien
mietspeigel	mietspiegel
atilik	satilik
horan's	horan
premeir	premier
shakesspeare	shakespeare
einstin	einstein
sondaki	sondakika
drection	direction
immobilíen	immobilien
wayans,	wayans
scientis	scientist
fährhaus,	fährhaus
freuns	freund
eisentablette	eisentabletten
renault.	renault
santaria	santeria
analverkeht	analverkehr
totely	totally
weißheitszähne	weisheitszähne
cebtral	central
bläßchen	bläschen
ultimar	ultimate
ahnenphoenix	ahnenphönix
foçada	focada
sherlock:	sherlock
ionescos	ionesco
leberty	liberty
flan´s	flan's
kurzhharfrisuren	kurzhaarfrisuren
befrüchtung	befruchtung
sulzbah	sulzbach
antcom	ant.com
zuordnungseinheit	zuordnungseinheiten
woihnung	wohnung
pickmentflecken	pigmentflecken
heartbrake	heartbreak
directionn	direction
algazeera	aljazeera
punctation	punctuation
feminien	feminin
myfitness	fitness
scarbourough	scarborough
galaky	galaxy
channig	channing
handrang	harndrang
radiactive	radioactive
lothing	loathing
haarfarb	haarfarbe
talasda	talasta
schreistunden	schreistunde
grooped	groped
orthello	othello
zermanova	zemanova
possitions	positions
härter.	härter
command:	command
unglucklich	unglücklich
schattenhafter	schattenhaften
blasenentzundung	blasenentzündung
unlülerin	ünlülerin
eischprung	eisprung
aussault	assault
mischaut	mischhaut
şehire	sehire
hunter3	hunter
mounain	mountain
lyriucs	lyrics
chrimson	crimson
zweiglinge	zweigling
wohhung	wohnung
scheoner	schöner
neymar's	neymar
cherleeder	cheerleader
mastrubration	masturbation
hottests	hottest
firsuren	frisuren
stewert	stewart
assassind	assassins
trödekmarkt	trödelmarkt
schwagerschaftstest	schwangerschaftstest
obstflecke	obstflecken
nstrike	strike
playwer	player
bekimmt	bekommt
stuhlgan	stuhlgang
gebarmutterschleimhaut	gebärmutterschleimhaut
awesome:	awesome
.akamaihd.net	a.akamaihd.net
webseites	website
nothing´s	nothing's
/playsound	playsound
katnis	katniss
flussigkeit	flüssigkeit
sweather	sweater
mönchspeffer	mönchspfeffer
litttle	little
eastwoods	eastwood
seattlepi	seattle
samsuing	samsung
comidies	comedies
beautiul	beautiful
kupferspiess	kupferspieß
blaschen	bläschen
beaitiful	beautiful
dieries	diaries
assassines	assassins
stellugen	stellungen
aktinson	atkinson
programación	programacion
wohnubgen	wohnungen
tiffanies	tiffany
lõschen	löschen
directione	direction
dishonred	dishonored
backstrett	backstreet
svhmerzen	schmerzen
barracks,	barracks
brakwade	brackwede
kopiergeschütze	kopiergeschützte
heaveb	heaven
tinker's	tinkers
rosalic	rosaliac
lsyrics	lyrics
belatrix	bellatrix
filkritik	filmkritik
mandalinalı	mandalinali
cyruse	cyrus
wohnunf	wohnung
zauberspruche	zaubersprüche
shwanger	schwanger
gurbey	gürbey
ksufen	kaufen
trödelkaffee	trödelcafe
alamur	amalur
meitspiegel	mietspiegel
ubuntun	ubuntu
radeom	radeon
garban	gabage
cervélo	cervelo
vibratos	vibrator
albträumen	alpträumen
çaresini	caresini
selnea	selena
awkward.	awkward
ekşili	eksili
d’orsay	d'orsay
silvir	sivir
tiberlake	timberlake
sternzeichens	sternzeichen
minzoel	minzöl
rehead	redhead
emanuelles	emanuelle's
anzeiche	anzeichen
richtog	richtig
haarasufall	haarausfall
clomofin	clomifen
furiouse	furious
explorer:	explorer
believin	believing
hircines	hircine
kaloreien	kalorien
brokovich	brockovich
macklamore	macklemore
minecrqft	minecraft
inegolde	inegölde
minnimap	minimap
gouvenor	governor
cricker	cricket
abendrituale	abendritual
festpatte	festplatte
mobafir	mobafire
volkstribune	volkstribun
periide	periode
narzistische	narzisstische
itamin	vitamin
www.polli	www.polly
washingtion	washington
stewart.	stewart
regnen,	regnen
beautifuls	beautiful
kurzhaarfriesur	kurzhaarfrisuren
eiprung	eisprung
gefaehrten	gefährten
asssassins	assassins
insidious:	insidious
micheliin	michelin
paltrow,	paltrow
shaileen	shailene
necraft	minecraft
mabook	macbook
herauswachsen	rauswachsen
süresinin	suresinin
schmekt	schmeckt
anfroid	android
parition	partition
weinachtsplätzchen	weihnachtsplätzchen
bartholini	bartholin
örding	oerding
kangaete	kangaetemo
island2	island
gätgen	gätgens
zellenhöhe	zeilenhöhe
whitherspoon	witherspoon
erriccson	ericsson
frisueren	frisuren
davutlarda	davutlar
fettender	fettiger
gefaehrlichsten	gefährlichsten
daily.	daily
conting	counting
troplowitzstrasse	troplowitzstraße
erricsson	ericsson
muslüm	müslüm
tigrgna	tigrigna
schlafritual	schlafrituale
pornstart	pornstar
m0nster	monster
patrón	patron
wohnunk	wohnung
energiepaß	energiepass
immowelt.	immowelt
festplaate	festplatte
segonda	segunda
pérego	perego
andrpid	android
chopra's	chopra
activity:	activity
leaugue	league
www.schüler	www.schueler
wiederherstellen,	wiederherstellen
walraf	wallraf
vitualbox	virtualbox
thimgs	things
surandon	sarandon
residnt	resident
pinket	pinkett
maganzine	magazine
legnds	legends
ferengie	ferengi
djungo	django
depressivem	depressiven
mönchpfeffer	mönchspfeffer
achords	chords
wwwbarbie	www.barbie
hathaway,	hathaway
lyricws	lyrics
kaaufen	kaufen
wouldn´t	wouldn't
copyshops	copyshop
ovitrell	ovitrelle
kraftet	craftet
grossschwert	großschwert
itemguide	itembuild
ericsoon	ericsson
blutunge	blutung
mogole	mongole
umutzuz	umutsuz
bishock	bioshock
seyffers	seyffer's
sachsische	sächsische
orgasmuss	orgasmus
cyrua	cyrus
beziehunh	beziehung
pistorious	pistorius
wohbungen	wohnung
celebrits	celebrity
restauratn	restaurant
thousend	thousand
paguinas	paginas
abgesichertes	abgesicherter
runterzuholen	runterholen
zetsubō	zetsubou
habereleri	haberleri
damsung	samsung
carrote	carrot
aspier	aspire
kamasurta	kamasutra
glucklich	glücklich
4chord	chords
nützlichste	nützliche
crosoft	microsoft
40seconds	seconds
schluken	schlucken
buddle	bubble
movafire	mobafire
gaytime	daytime
eigemtumswohnung	eigentumswohnung
heqrt	heart
schmerzeb	schmerzen
nowwhere	nowhere
vicroria	victoria
mubacher	mubasher
jetrzt	jetzt
jeniifer	jennifer
sjyrim	skyrim
^fallout	fallout
beziehing	beziehung
othing	nothing
positsion	position
naessende	nässende
naegelkauen	nägelkauen
heiligenstädt	heyligenstaedt
makarnalı	makarnali
i.supershape	supershape
kurzhaarfrisueren	kurzhaarfrisuren
apfelkuch	apfelkuchen
lizenzkeys	lizenzkey
tùrkiye	türkiye
fruchtsaure	fruchtsäure
ungelesenen	ungelesene
abnehem	abnehmen
gangman	gangnam
vericem	verecegim
fighters:	fighters
agulira	aguilera
anhaenglich	anhänglich
gesvhichten	geschichten
resultati	risultati
,ieten	mieten
jüngerem	jüngeren
beaking	breaking
wohnungin	wohnung
detetkiv	detektiv
puckern	pochen
überschwemmte	überschwemmter
thrity	thirty
parcific	pacific
redemptions	redemption
stuhlgsng	stuhlgang
kavfen	kaufen
lyxrics	lyrics
meier´s	meier's
würgreflex	würgereflex
lieberti	liberty
guiitar	guitar
garner's	garner
absetztn	absetzen
sperars	spears
shippûden	shippuuden
rotweinfleck	rotweinflecken
paßwörter	passwörter
dungeon:	dungeon
literaturcafé	literaturcafe
einnistungblutung	einnistungsblutung
d'feldwies	feldwies
wouhnung	wohnung
mietwognungen	mietwohnungen
moskovanın	moskovanin
knox:	knox
nvidias	nvidia
gentumswohnung	eigentumswohnung
kennwortrichtlinie	kennwortrichtlinien
gugelhupfe	gugelhupf
abschabung	ausschabung
scarlette	scarlett
synmaster	syncmaster
bloomberk	bloomberg
wohunng	wohnung
depech	depeche
malage	malaga
scientest	scientist
antiobiotikum	antibiotika
www.xing.	www.xing
polemon	pokemon
taylos	taylor
fantasx	fantasy
dirction	direction
agreer	agréer
rpublic	republic
pivkel	pickel
banghart	banghard
narzistischer	narzisstischer
schwangerschaftstes	schwangerschaftstest
chritmas	christmas
janies	janie's
mosss	moss
orgsamus	orgasmus
icloude	icloud
augilera	aguilera
eisrung	eisprung
nigaas	niggas
ausschläge	ausschlag
rtl8168d/8111d	rtl8168/8111
minecraft5	minecraft
betaeubung	betäubung
confortably	comfortably
moutain	mountain
filmstsrts	filmstarts
lungenreifung	lungenreife
breakng	breaking
hūrriyet	hürriyet
horroscope	horoscope
nautilius	nautilus
friuren	frisuren
lkyrics	lyrics
vaginalem	vaginaler
urindrang	harndrang
sudens	südens
geißens	geissens
flammazin	flammazine
centipide	centipede
jazzera	jazeera
haarfrisueren	haarfrisuren
currículum	curriculum
nasenspry	nasenspray
kotbusser	kottbusser
hamilelerde	hamilelikte
mibecraft	minecraft
kiji.de	kijiji
realtek®	realtek
ibrahimlide	ibrahimli
harnröre	harnröhre
krokolistenbauch	krokiliskenbauch
pozycję	pozycje
sporthead	sportshead
adventuren	adventure
befriediegen	befriedigen
pornsatrs	pornstars
schampoo	shampoo
beezleboss	beelzeboss
kurzharrfrisuren	kurzhaarfrisuren
eiversüchtig	eifersüchtig
verhütungen	verhütung
rastaurants	restaurant
glaubt,	glaubt
mietspielgel	mietspiegel
tenault	renault
ovaluationstest	ovulationstest
mittellangem	mittellanges
mavricks	mavericks
frsieur	friseur
cthulhu:	cthulhu
magazne	magazine
skyfall,	skyfall
eiweissreiches	eiweißreiches
galaxxy	galaxy
zimmwr	zimmer
befriedig	befriedigt
özderede	özdere
robbiw	robbie
mandelentzundung	mandelentzündung
zufuettern	zufüttern
schsuspieler	schauspieler
kardialer	kardiale
tuture	torture
retter,	retter
zellenbezug	zellbezug
kalbindeki	kalbimdeki
immpossible	impossible
kaufenim	kaufen
vitamim	vitamin
ideacenter	ideacentre
achmerzen	schmerzen
gildenraids	gildenraid
schlukauf	schluckauf
schluesselfertiges	schlüsselfertiges
justint	justin
geachichte	geschichte
capote's	capote
nauhgty	naughty
midleton	middleton
poppen.	poppen
kyōkai	kyoukai
.jetzt	jetzt
delevingn	delevingne
frizzel	frizzle
hùrriyet	hürriyet
operier	operieren
musterhausparks	musterhauspark
wohning	wohnung
com.sec.android.app.twlauncher)	com.sec.android.app.twlauncher
fisuren	frisuren
durchblutungsstoerungen	durchblutungsstörungen
zerfixschleim	zervixschleim
abgesetzter	abgesetzte
republich	republic
kapselriß	kapselriss
blahniks	blahnik
emerson,	emerson
kurzhaarefrisuren	kurzhaarfrisuren
uominie	uomini
griechiescher	griechischer
blutflecke	blutflecken
videoto	videos
khediras	khedira
dtagon	dragon
amular	amalur
studio®	studio
acrobate	acrobat
vibratior	vibrator
wandrin	wandering
kaufin	kaufen
nußecken	nussecken
chapelles	chappelle's
scjwanger	schwanger
millionär,	millionär
patrition	partition
fauligen	fauliger
penolope	penelope
l`wren	l'wren
jennier	jennifer
stimmungschwankungen	stimmungsschwankungen
cellulitte	cellulite
blonns	bloons
verfuhren	verführen
portakall	portakalli
reident	resident
permier	premier
namazında	namazinda
galazy	galaxy
kuroku	kuroko
hurriyet.	hürriyet
sprühkuren	sprühkur
something’s	something's
zornfalte	zornesfalte
requelme	riquelme
montessoris	montessori
syfried	seyfried
sahipinden	sahibinden
felmoching	feldmoching
cricekt	cricket
ungespeicherte	gespeicherte
kauufen	kaufen
tschaikowskys	tschaikowsky
scgmerzen	schmerzen
dahila	dahlia
altonas	altonaer
schwarzeneggers	schwarzenegger
ocolus	oculus
sytles	styles
zeppeling	zeppelin
wenthworth	wentworth
auslogic	auslogics
kristn	kristen
kamsautra	kamasutra
ironamn	ironman
richtif	richtig
nudist,	nudist
scwanger	schwanger
udashurova	dashurova
upstall	uppstall
mayadin	mayadeen
zensoren	zensor
p.e.k.k.a.	p.e.k.k.a
kaugen	kaufen
flouretten	fluoretten
mundwinkel,	mundwinkel
gefaerbt	gefärbt
cuéntame	cuentame
schwangetschaft	schwangerschaft
scarner	skarner
rûyada	rüyada
wasn´t	wasn't
abstillt	abstillen
gestoert	gestört
erregtion	erektion
tireboluda	tirebolu
drangons	dragons
2broke	broken
biskuvili	bisküvili
belucci	bellucci
terrarria	terraria
rertro	retro
hiddlestone	hiddleston
bluting	blutung
chearleaders	cheerleader
dündarin	dündar
protable	portable
logiktests	logiktest
intimebereich	intimbereich
abnhemen	abnehmen
muskelkarter	muskelkater
affäre,	affäre
zkt.	zkt
sinéad	sinead
finals:	finals
yugioh!	yugioh
hamurun	hamuru
comedz	comedy
bruechige	brüchige
ungeschützen	ungeschützten
wojnung	wohnung
stillen,	stillen
águila	aguila
gecesini	gecesi
direcotry	directory
cowell's	cowell
bascet	basket
geschützes	geschütztes
abnhmen	abnehmen
talyor	taylor
schwangerscahft	schwangerschaft
wendlers	wendler
unerfülltem	unerfüllter
testure	texture
sugering	sugaring
providon	povidon
multtiplayer	multiplayer
annekee	anekee
(3gio)	3gio
peelings	peeling
postions	positions
eingewoehnung	eingewöhnung
tempest,	tempest
choniken	chroniken
rachenzäpfchen	gaumenzäpfchen
okuncak	okunacak
lyricds	lyrics
rausziehn	rausziehen
hamburgb	hamburg
kostenlöse	kostenlose
klimatabell	klimatabelle
graufreund	graufreud
glätteeisen	glätteisen
maturel	mature
wognung	wohnung
dragon´s	dragon's
datenrettungs	datenrettung
impossibel	impossible
lyriscs	lyrics
washingotn	washington
terrari	terraria
kamasztra	kamasutra
verpasst.	verpasst
thatchers	thatcher
tenacios	tenacious
guncel	güncel
bootabel	bootable
scharmbein	schambein
tropenbäume	tropenbaum
caputre	capture
gÜnesi	günesi
documentarys	documentaries
şekerbank	sekerbank
wınrar	winrar
lieblingstellung	lieblingsstellung
pilleeinnahme	pilleneinnahme
wraking	wrecking
immob.in	immobilien
bollboard	billboard
penélope	penelope
drueckt	drückt
xeperia	xperia
virtualer	virtual
selbstbefriediging	selbstbefriedigung
hauslauf	hauskauf
damenfriesuren	damenfrisuren
sestellungen	stellungen
butterplätchen	butterplätzchen
bindin	binding
molekuele	moleküle
fluessigkeit	flüssigkeit
list's	list
lima's	lima
borthday	birthday
unicorne	unicorn
hürriyetin	hürriyet
síntomas	sintomas
wuergereiz	würgereiz
zinmer	zimmer
denning	dennings
washingtin	washington
eiegntumswohnungen	eigentumswohnungen
abknickender	abknickende
gayyetta	gazzetta
dolomin	dolormin
v.kontakte.ru	vkontakte.ru
zahnluecke	zahnlücke
mietenn	mieten
macbok	macbook
haarverlangerung	haarverlängerung
emperor:	emperor
clickers	clicker
erotischten	erotischsten
lyriocs	lyrics
prawidłowa	prawidlowa
westernhage	westernhagen
soutuh	south
ringelrötel	ringelröteln
yorkt	york
tiramisú	tiramisu
sykrim	skyrim
schneeblöcke	schneeblock
ottense	ottensen
alittle	little
hitzeschlag	hitzschlag
timesof	times
erozische	erotische
immobiliein	immobilien
horscopo	horoscopo
passowort	passwort
volibar	volibear
kaufgen	kaufen
napoleon:	napoleon
flechtefrisuren	flechtfrisuren
hotttest	hottest
www.stadoll	www.stardoll
texure	texture
dragond	dragons
pubkte	punkte
spnking	spanking
billboad	billboard
vanbasco's	vanbasco
lryrics	lyrics
durchführen,	durchführen
80211g	802.11g
whstsapp	whatsapp
madiso	madison
kuafen	kaufen
koffeinfreien	koffeinfreier
tekken:	tekken
schwangerschaftstests	schwangerschaftstest
bundeslände	bundesländer
kikelli	kekilli
whatsaoo	whatsapp
swinget	swinger
sve1511a1eb	sve1511a1ew
sacrefice	sacrifice
lyrfics	lyrics
sesason	season
front:	front
hercules:	hercules
worlds:	worlds
yustin	justin
komedogenes	komedogen
hämmorrhoiden	hämorrhoiden
athlethes	athletes
maslows	maslow
gesxhichten	geschichten
5seconds	seconds
celbrity	celebrity
todes:	todes
scheangerschaft	schwangerschaft
horoscpe	horoscope
lysrics	lyrics
origans	origins
grid:	grid
drgons	dragons
platzenta	plazenta
flohbiß	flohbiss
fliesst	fließt
pornatar	pornstar
jimmy´s	jimmy's
beyazlanmis	beyazlamis
achselschweis	achselschweiß
pumkins	pumpkins
faufen	kaufen
pornstrs	pornstars
vcontakte.ru	vkontakte.ru
alleinigem	alleiniges
shywana	shyvana
assimetrische	asymmetrische
jahr..!	jahr...!
slyrim	skyrim
clomifin	clomifen
farbgefühl	farbgefühle
pirates!	pirates
kanalde	kanald
winter`s	winter's
verschlüßeln	verschlüsseln
kiaufen	kaufen
hostel7	hostel
fdamen	frauen
fidgets	fidget
sailik	satilik
bullock's	bullock
migrationsassistenten	migrationsassistent
dammned	damned
synomys	synonym
ranschid	ranjid
dominaten	dominanten
stumple	stumble
rhiannas	rihanna
medienscanning	medienscanner
machlemore	macklemore
hatalarımdan	hatalarimdan
arcor.	arcor
epillieren	epilieren
kaugfen	kaufen
mozillas	mozilla
pornstras	pornstars
wasserlassen,	wasserlassen
shuhrete	shyhrete
riannah	rihanna
verpacten	verpachten
sxhmerzen	schmerzen
(hear	hear
desrie	desire
schleimlösendes	schleimlösende
breakig	breaking
christmas,	christmas
geliboluda	gelibolu
kurzhaafrisuren	kurzhaarfrisuren
uskauf	hauskauf
hugens	hudgens
vertex2	vertex
o’dell	o'dell
kapoor's	kapoor
aussschabung	ausschabung
nagelkauen	nägelkauen
schawanger	schwanger
ciğeri	cigeri
rätsel:	rätsel
vicevers	viceversa
stilzeit	stillzeit
2cimmer	2zimmer
ikonia	iconia
terrazino	terrazzino
masutra	kamasutra
pcikel	pickel
emulater	emulator
avatar:	avatar
hurriyey	hurriyet
haberlero	haberleri
clebrity	celebrity
weather.	weather
unicid	unacid
sparacus	spartacus
niedrigst	niedrig
multiculturism	multiculturalism
macklermore	macklemore
schäft	schläft
hitlon	hilton
decemberist	decemberists
schmerze	schmerzen
feyenord	feyenoord
gesciht	gesicht
einistungsblutung	einnistungsblutung
schwangerschaft,	schwangerschaft
schmittz	schmitz
waerend	während
permission.yml	permissions.yml
utlimate	ultimate
blasenendzündung	blasenentzündung
regionalcodes	regionalcode
jjustin	justin
ferstplatte	festplatte
erkilette	erkilet
eisprumg	eisprung
hichsteckfrisuren	hochsteckfrisuren
radikal.	radikal
ornaniere	onaniere
huntsmen	huntsman
feenfluegel	feenflügel
verknüpfungspfeil	verknüpfungspfeile
freemaker	freemake
stadtcafé	stadtcafe
partitionsgrösse	partitionsgröße
gouldings	goulding
yalikavakta	yalikavak
sinatra,	sinatra
airliners.	airliners
nécib	necib
shishan	shisha
lidsay	lindsay
stopeln	stoppeln
leagur	league
hairschnitt	haarschnitt
zahnlücken	zahnlücke
harausfall	haarausfall
zukunftsicherung	zukunftssicherung
sexstape	sextape
duty:	duty
skylanders.	skylanders
coolmaths	coolmath
geyiklide	geyikli
aguelera	aguilera
leabian	lesbian
renaiult	renault
canlin	canli
seitenzöpfe	seitenzopf
witherspoons	witherspoon
virtuellbox	virtualbox
speria	xperia
mantalist	mentalist
skysword	skyward
reaturant	restaurant
wognungen	wohnungen
püsu	pusu
torjaeger	torjäger
magersuchtig	magersüchtig
brustentzuendung	brustentzündung
wothout	without
halschmerzen	halsschmerzen
season10	season
icarus:	icarus
barnbek	barmbek
kofteli	köfteli
jungfraulichkeit	jungfräulichkeit
biberfell	biberfelle
pancaces	pancakes
marktplaatz	marktplaats
marple:	marple
hühnersuppen	hühnersuppe
ossibuchi	ossobuco
microsofrt	microsoft
ebloui	eblouie
mleten	mieten
friusren	frisuren
seadon	season
hunzicker	hunziker
entiempos	tiempos
flechtfirsuren	flechtfrisuren
mimecraft	minecraft
flanagan,	flanagan
katić	katic
siderreel	sidereel
schwanger,	schwanger
unterlieb	unterleib
hodenentzuendung	hodenentzündung
gylenhaal	gyllenhaal
e.clapton	clapton
wohnzngen	wohnungen
thinkcenter	thinkcentre
naruot	naruto
porable	portable
gratisan	gratis
eigentumswphnung	eigentumswohnung
behharte	behaarte
gümüsyakada	gümüsyaka
disire	desire
teberium	tiberium
kuruko	kuroko
brytney	britney
kraeuterblut	kräuterblut
sseason	season
esslingende	esslingen
durchnahme	durchnehmen
korkron	kor'kron
houswives	housewives
vorinstalierte	vorinstallierte
flechtfrisure	flechtfrisuren
filsmtarts	filmstarts
billbaord	billboard
revenges	revenge
chritsmas	christmas
40es5700	ue40es5700
saijajin	saiyajin
sontakika	sondakika
übelkei	übelkeit
mananero	mañanero
come:	come
stanković	stankovic
intimbreich	intimbereich
redident	resident
rapsberry	raspberry
tatlısesin	tatlisesin
schleimbälle	schleimball
assains	assassins
whatssapp	whatsapp
trockene,	trockene
selbstbefriedigung,	selbstbefriedigung
drakensnag	drakensang
builcraft	buildcraft
beautifil	beautiful
batille	bastille
trendfrisur	trendfrisuren
inkeepers	innkeepers
meridith	meredith
fotune	fortune
micalea	micaela
streep,	streep
4.monate	monate
monster's	monster
scheidenpilz,	scheidenpilz
turismo6	turismo
brustentzundung	brustentzündung
warriros	warriors
bahamuth	bahamut
plagiats	plagiat
grforce	geforce
reinhard's	reinhards
hirnhautentzundung	hirnhautentzündung
skyirim	skyrim
vadesi	vadisi
templegates	templegate
hsuskauf	hauskauf
geschichtrn	geschichten
impossible,	impossible
vampire:	vampire
partion	partition
potatoe	potato
klageanträge	klageantrag
resient	resident
nowitzkis	nowitzki
diarien	diaries
skytim	skyrim
haarsysteme	haarsystem
gnubel	knubbel
bauspiegelung	bauchspiegelung
andriid	android
gebaermuttersenkung	gebärmuttersenkung
.tar.gz	tar.gz
gefaehrlicher	gefährlicher
relevation	revelation
supprot	support
conrad's	conrad
extansions	extensions
myfegine	mifegyne
ruthemeier	ruthemeyer
punlic	public
el.tiempo	eltiempo
cónsul	consul
kekkili	kekilli
negativ.	negativ
scienic	scenic
goslings	gosling
hunderjährige	hundertjährige
herores	heroes
tenacius	tenacious
toengels	toengel
sexsstellungen	sexstellungen
cretures	creatures
burçlarla	burclarla
seminovich	semenovich
cirus	cyrus
efrons	efron
cormacks	mccormacks
twitcht	twitch
reistage	reistag
selbstbefrieigung	selbstbefriedigung
garmish	garmisch
outpost:	outpost
tinkpad	thinkpad
culkin's	culkin
huffinton	huffington
qohnung	wohnung
mioeten	mieten
originalnaht	originalsaum
conjouring	conjuring
kullmanns	kullman's
flammkuche	flammkuchen
celeberty	celebrity
catlyn	caitlyn
calıkusu	calikusu
affen:	affen
spröden	spröde
urzhaarfrisuren	kurzhaarfrisuren
verdrückt	unterdrückt
rezeopt	rezept
kaufeh	kaufen
synonymn	synonym
^samsung	samsung
wihnungen	wohnung
missionars	missionar
wainting	waiting
diomands	diamonds
stanalone	standalone
schampoos	shampoo
ministon	minisiston
birderlands	borderlands
mutterschutz,	mutterschutz
überziehn	überziehen
lettter	letter
kämmerer]	kämmerer
erkaltung	erkältung
heyek	hayek
warhammer:	warhammer
ruckbildung	rückbildung
hocksteckfrisur	hochsteckfrisuren
mobfire	mobafire
coulding	goulding
synoynms	synonym
orende	örende
promissed	promised
fachangestelllte	fachangestellte
monsiuer	monsieur
schnecke,	schnecke
reasin	reason
dólares	dolares
trokene	trockene
tennpenny	tenpenny
felcken	flecken
ergonyl	ergenyl
wunderbahre	wunderbare
.bundle	bundle
altaïr	altair
littli	little
namazlar	namazi
waxxing	waxing
seaseon	season
mogushan	mogu'shan
mobifire	mobafire
sawatski	sawatzki
sodalı	sodali
mietrn	mieten
stachelfische	stachelfisch
amdroid	android
conjugación	conjugacion
besondrer	besonderer
charakterization	characterization
season8	season
whireshark	wireshark
quiditch	quidditch
mietwphnung	mietwohnung
gelöchte	gelöschte
gouvernor	governor
masterburate	masturbate
brucies	brucie
fantasy7	fantasy
season9	season
tabline	tablinen
aguilere	aguilera
wadisi	vadisi
jenniver	jennifer
siderel	sidereel
fantsy	fantasy
mobafirer	mobafire
bendict	benedict
kalrien	kalorien
lyroics	lyrics
schmierblutungen	schmierblutung
shakespear	shakespeare
2.eishockey	eishockey
mandela:	mandela
restauranttip	restaurants
locken,	locken
guotar	guitar
accuwearher	accuweather
dragon’s	dragon's
www:pinoy	www.pinoy
selffie	selfie
motehr	mother
incedent	incident
arttiran	artiran
flaeschchen	fläschchen
kamasutra,	kamasutra
şehriyeli	sehriyeli
wtson	watson
whatspp	whatsapp
flüßigkeit	flüssigkeit
ofiril	orfiril
winhouse	winehouse
stardoll.	stardoll
pomemon	pokemon
kennnen	kennen
exlude	exclude
menueband	menüband
aljzeera	aljazeera
realisim	realism
olypus	olympus
winfows	windows
helgenberg	helgenberger
naruro	naruto
mandelentzuendung	mandelentzündung
galagxy	galaxy
ciyrus	cyrus
r/insertion	insertion
mandelop	mandel
venaflaxin	venlafaxin
umwandeln,	umwandeln
mietene	mieten
breking	breaking
jagaran	jagran
immóbilien	immobilien
ballettschuhen	ballettschuhe
weidenalle	weidenallee
gezmisin	gezmis
lorestone	lorestones
senkwehe	senkwehen
mundecke	mundecken
lavigne's	lavigne
gutiar	guitar
yilmazin	yilmaz
haareschnitt	haarschnitt
rksich	rkisch
desicions	decisions
narzisten	narzissten
onyxeier	onyxei
schöneber	schöneberg
drinks?	drinks
ozbourne	osbourne
mallirca	mallorca
eingefallenen	eingefallene
downey,	downey
abyb	baby
loepard	leopard
ueberruhr	überruhr
pressestimme	pressestimmen
minexraft	minecraft
mastrubiere	masturbiere
skyrim.	skyrim
ausfuss	ausfluss
haarfriesuren	haarfrisuren
scottich	scottish
outmeal	oatmeal
kaufern	kaufen
eronews	euronews
gzeiten	gezeiten
revalations	revelations
intensiveren	intensiverer
saldanhas	saldanha
weihnachsplätzchen	weihnachtsplätzchen
haselnußmakronen	haselnussmakronen
directoin	direction
geraeucherter	geräucherter
lítaliano	l'italiano
3.staffel	staffel
bedten	besten
acitivity	activity
eisprun	eisprung
schwangwr	schwanger
race:	race
doloposterin	doloposterine
freunding	freundin
cryrus	cyrus
besprochen,	besprochen
furious7	furious
zulassen,	zulassen
hackeschen	hackescher
abfuhrmittel	abführmittel
ultrachall	ultraschall
schwangerscgaft	schwangerschaft
jeniffer	jennifer
japanase	japanese
www.poly	www.polly
pkayer	player
warbringers	warbringer
erotsche	erotische
mirenda	miranda
vobrator	vibrator
salatı	salati
guiatar	guitar
puddingli	pudingli
celebryty	celebrity
vergessem	vergessen
bordwalk	boardwalk
arisina	agrisina
dippemesse	dippemess
fstplatte	festplatte
dell’orefice	dell'orefice
kyodum	koydum
blutung,	blutung
durschnittsgröße	durchschnittsgröße
handyortungs	handyortung
expria	xperia
xl2420	xl2420t
vkontankte	vkontakte
anschlußkennung	anschlusskennung
whitestripes	whitestrips
derülo	derulo
paramore:	paramore
blowjib	blowjob
benachmark	benchmark
thoery	theory
ereignissanzeige	ereignisanzeige
sparnotes	sparknotes
sternzeich	sternzeichen
blutschwämchen	blutschwämmchen
rizinusol	rizinusöl
dihonored	dishonored
wohnungén	wohnungen
gleidgel	gleitgel
america:	america
immobillein	immobilien
kleinreperaturen	kleinreparaturen
arianda	ariana
webisoden	webisodes
käsekuche	käsekuchen
citolopram	citalopram
biebeer	bieber
jackmann	jackman
allysa	alyssa
grünlichen	grünlicher
beatles:	beatles
sskyrim	skyrim
celebertys	celebrity
fressatacke	fressattacke
scheidenentzuendung	scheidenentzündung
decursiv	decursive
pirates:	pirates
concita	conchita
yokr	york
waermeleitpaste	wärmeleitpaste
shivana	shyvana
hämocult	hämoccult
schusterman	schustermann
androidd	android
lehmsahl	lemsahl
festlatte	festplatte
fioara	fiora
laufwerkbuchstaben	laufwerksbuchstaben
miieten	mieten
courtny	courtney
frendin	freundin
gebärmutte	gebärmutter
forecas	forecast
schwellt	schwillt
aguliera	aguilera
cinatown	chinatown
ankaufsportal	ankaufportale
mr.morgans	mr.morgan's
cahmpions	champions
hämorriden	hämorrhoiden
unvorgiven	unforgiven
piericng	piercing
ovalution	ovulation
skylanders:	skylanders
hx10vs	hx10v
immodium	imodium
lyruics	lyrics
leageu	league
predjudice	prejudice
macbooc	macbook
pişirsem	pisirsem
zählewenn	zählenwenn
creppypasta	creepypasta
fiebert	fieber
spragel	spargel
recoverz	recovery
seymoure	seymour
gregorelli	gregorellis
emberassing	embarrassing
americab	american
geschivhten	geschichten
liedschatten	lidschatten
kurhaarfrisuren	kurzhaarfrisuren
puece	piece
sreenshot	screenshot
gleichförmigen	gleichförmige
backschlauch	bratschlauch
kalorein	kalorien
mitlife	midlife
chandalier	chandelier
ekennt	erkennt
pronce	prince
moveies	movies
freudnin	freundin
jessiva	jessica
brustvergröserung	brustvergrößerung
sensatin	sensation
jurrasic	jurassic
hiltin	hilton
schwanherschaft	schwangerschaft
würgereitz	würgereiz
muckenstiche	mückenstiche
eigentumswhnung	eigentumswohnung
caedeus	ceadeus
baumgarter	baumgartner
jugment	judgment
hämmorhoiden	hämorrhoiden
gedchichten	geschichten
satllik	satilik
nodepad	notepad
craftin	crafting
hayaler	hayaller
raecher	rächer
jungfreulichkeit	jungfräulichkeit
celebrietes	celebrities
schwanger!	schwanger
minefraft	minecraft
natanja	nathanja
poece	piece
schweinefilets	schweinefilet
corriee	corriere
wohhnung	wohnung
tuneln	tunein
broadwell.	broadwell
unregelmässige	unregelmäßige
vtamin	vitamin
ölüdenizde	ölüdeniz
fijifilm	fujifilm
synoyms	synonym
khalfia	khalifa
traube,	traube
gursesin	gurses
karatasta	karatas
gesäßmuskeln	gesäßmuskel
lindesy	lindsey
schaamhaare	schamhaare
azlyrics	lyrics
vulgrims	vulgrim
filmstarts.	filmstarts
Öyster	oyster
olivenol	olivenöl
defaint	defiant
leagze	league
renesmée	renesmee
drafon	dragon
thatcher,	thatcher
activity4	activity
verführ	verführe
portnstars	pornstars
geheimnisse]	geheimnisse
korperfett	körperfett
commander2	commander
pentouse	penthouse
sytemanforderungen	systemanforderungen
kongdom	kingdom
cathing	catching
soframız	soframiz
dead:	dead
serversign	serversigns
krappeln	krabbeln
calmavera	calmvalera
aether2	aether
adnroid	android
ozo's	ozo
dkyrim	skyrim
assassains	assassins
beyond:	beyond
gouding	goulding
nemački	nemacki
inuzuma	inazuma
eileiterentzuendung	eileiterentzündung
season4	season
währender	während
fruchblase	fruchtblase
assissins	assassins
takika	dakika
potter.	potter
beschäftigungverbot	beschäftigungsverbot
fantsay	fantasy
priates	pirates
morrigan's	morrigan
channin	channing
aguleria	aguilera
abnehemn	abnehmen
tayakadın	tayakadin
minikago	minika
divian	deviant
getraumt	geträumt
winecraft	minecraft
pornstsrs	pornstars
jemeson	jameson
heimedinger	heimerdinger
analthrombosen	analthrombose
cuckoos	cuckoo's
chaoter	chapter
scheidepilz	scheidenpilz
go.exe	csgo.exe
bildcombo	bildkombo
unchaned	unchained
wouldnt	wouldn't
diaries:	diaries
babycenter.	babycenter
femurlaenge	femurlänge
sommerhalder	somerhalder
keeting	keating
polaken	polacken
resaturant	restaurant
kalkanda	kalkan
süsslicher	süßlicher
mackemore	macklemore
gwineth	gwyneth
frisren	frisuren
befruchtung,	befruchtung
yébenes	yebenes
kingdomes	kingdoms
tiberum	tiberium
strassenmühle	straßenmühle
screemshot	screenshot
linsday	lindsay
lawson's	lawson
brdige	bridge
(stronger)	stronger
spinner's	spinners
papierkorbs	papierkorb
selbser	selber
créateurs	createurs
nobody's	nobodys
johannson	johansson
geknickter	geknickte
euronws	euronews
uhrinová	uhrinova
attorny	attorney
löyrics	lyrics
dovizli	dövizli
tinight	tonight
haberler.	haberler
cobbie	colbie
predator:	predator
hottesr	hottest
bugunkü	bugünkü
gazetesi.	gazetesi
ünlulerin	ünlülerin
netzhautabloesung	netzhautablösung
schmalippen	schamlippen
gefahrten	gefährten
harrschnitt	haarschnitt
koçyigit	kocyigit
taskleist	taskleiste
fanatik.	fanatik
hypophysentumore	hypophysentumor
erklältung	erkältung
aniversário	aniversario
kraeftige	kräftige
filmstartd	filmstarts
littly	little
schamlippen,	schamlippen
seymour's	seymour
androif	android
wwwkostenlos	www.kostenlos
sidereeel	sidereel
orgasmus.	orgasmus
gesichtsoel	gesichtsöl
celebratie	celebrity
kontaksperre	kontaktsperre
cremigen	cremiger
sennastad	sennestadt
voyager,	voyager
verschlusseln	verschlüsseln
stellunen	stellungen
leagie	league
papasitos	pappasitos
carver,	carver
dateinen	dateien
timberlake,	timberlake
misa’s	misa's
nierenbeckenentzundung	nierenbeckenentzündung
lungenoedem	lungenödem
soliaire	solitaire
sonnebrand	sonnenbrand
bohlens	bohlen
yüzyili	yüzyil
kehlkopfentzuendung	kehlkopfentzündung
kaufscript	buyscript
heschichten	geschichten
schwangerschafft	schwangerschaft
speedmeter.	speedmeter
scheuler	schüler
ankarani	ankaranin
nordbayer	nordbayern
fimkritik	filmkritik
windberg,	windberg
aspiere	aspire
scissorhand	scissorhands
beyonve	beyonce
betaisadonna	betaisodona
brustvergrößerungen	brustvergrößerung
www.vkontacte.ru	www.vkontakte.ru
wonderwal	wonderwall
lyricsc	lyrics
geheimnissvollen	geheimnisvollen
justic	justice
ultmate	ultimate
xperias	xperia
pronstars	pornstars
wireframing	wireframe
uptons	upton
statuse	status
wpohnung	wohnung
vallete	valette
startbat	start.bat
rueckbildung	rückbildung
revodrive3	revodrive
partitionsgrößen	partitionsgröße
macook	macbook
lahmacunu	lahmacun
kasufen	kaufen
hausermann	hauserman
gyllenhal	gyllenhaal
gebarmutterentfernung	gebärmutterentfernung
garfunkel,	garfunkel
frrund	freund
erwerbsregel	erwerbsregeln
eispring	eisprung
eierstockentzuendung	eierstockentzündung
dädra	daedra
dishonord	dishonored
dirchfall	durchfall
corrierer	corriere
commaner	commander
bronchitits	bronchitis
abtreibung,	abtreibung
10minutes	minutes
zahnende	zahnen
obafire	mobafire
alemdarin	alemdar
falllout	fallout
geachichten	geschichten
wiiliams	williams
runterhohlen	runterholen
ww.jetzt	www.jetzt
apfelkuche	apfelkuchen
guy:	guy
candidos	candido
franco's	franco
gosupermodel.	gosupermodel
christma	christmas
hosentrends	modetrends
alfredos	alfredo
suicied	suicide
qulaira	qlaira
wohnzng	wohnung
bromelaine	bromelain
galaxyy	galaxy
textuer	texture
lavingne	lavigne
hallelijah	hallelujah
bouncin	bouncing
inpfung	impfung
fruchsäurepeeling	fruchtsäurepeeling
pričaonica	pricaonica
jutice	justice
floora	floors
swohnung	wohnung
furous	furious
sichelfuss	sichelfuß
zimmee	zimmer
ovgide	ovguide
einstiegssätze	einstiegssatz
nkaufen	kaufen
kindercafé	kindercafe
jusitn	justin
whiterspoon	witherspoon
sugarin	sugaring
wachstumsschübe	wachstumsschub
(titoli)	titoli
acımak	acimak
besıktas	besiktas
www.babi	www.barbie
zwickt's	zwickts
nacional,	nacional
clancy´s	clancy's
motrate	motrat
scgwangerschaft	schwangerschaft
assassans	assassins
shivanna	shyvana
manavgatda	manavgat
(pretty	pretty
shouldve	should've
pacifc	pacific
mevlanin	mevlana
ultimater	ultimate
tiramisù	tiramisu
betretbare	begehbare
sperna	sperma
erlagnen	erlangen
maquilhagem	maquiagem
fuehlt	fühlt
marmelatlı	marmelatli
beşler	besler
minajs	minaj
songtexz	songtext
tunderbolt	thunderbolt
anderso	anderson
dermatits	dermatitis
magengeschwur	magengeschwür
trek:	trek
woohnung	wohnung
schwanen,	schwanen
firseur	friseur
dutx	duty
japaneses	japanese
furnance	furnace
viceversas	viceversa
formatieren,	formatieren
traenenkanal	tränenkanal
paracethamol	paracetamol
lyricss	lyrics
(marius	marius
gainsbourgh	gainsbourg
brothet	brother
stahlrim	stalhrim
schlaftabletten,	schlaftabletten
hautazrt	hautarzt
80'ler	80ler
twitch.	twitch
seatool	seatools
inecraft	minecraft
councelor	counselor
chessecake	cheesecake
shanea	shenae
celebrtity	celebrity
assasians	assassins
mandelentzündungen	mandelentzündung
seecra	secraa
fishborn	fishburne
knightly	knightley
tagaryen	targaryen
bindehautenzündung	bindehautentzündung
betruetes	betreutes
eigentumswohnung.	eigentumswohnung
flmstarts	filmstarts
teture	texture
embarrising	embarrassing
tatoed	tattoo
volturis	volturi
darkness:	darkness
abnehmne	abnehmen
macboock	macbook
bexonce	beyonce
iparfumeri	iparfumerie
glücklichstes	glücklichste
bätterteig	blätterteig
schwnagerschaft	schwangerschaft
geschichteb	geschichten
hussein's	hussein
cuocco	cuoco
schlafrn	schlafen
horzion	horizon
feemale	female
schilddrusenunterfunktion	schilddrüsenunterfunktion
talkdrüsen	talgdrüsen
blahungen	blähungen
scrennshot	screenshot
imposssible	impossible
standiger	ständiger
davient	deviant
orgasmus,	orgasmus
tiebarg	tibarg
rihannas	rihanna
^barbie	barbie
süleyman'in	süleymanin
marceu	marceau
sherloch	sherlock
cranel	cranell
brewer's	brewers
bademlide	bademli
2.zyklus	zyklus
weathe	weather
bierber	bieber
demnaechst	demnächst
mylittle	little
eigentumswohunung	eigentumswohnung
dinger's	dingers
schades	shades
gesichr	gesicht
azeala	azalea
regijonalna	regionalna
durchfa	durchfall
kurzhaarfisuren	kurzhaarfrisuren
desktop®	desktop
gefoce	geforce
thinderbird	thunderbird
bahcesehirde	bahcesehir
getaufte	getauft
oragsmus	orgasmus
fotamaç	fotomac
fkurzhaarfrisuren	kurzhaarfrisuren
agiulera	aguilera
thaumacraft	thaumcraft
schmerzn	schmerzen
rueckbildungsgymnastik	rückbildungsgymnastik
monates	monate
gebaermutterhalskrebs	gebärmutterhalskrebs
gamereplay	gamereplays
sahbinden.com	sahibinden.com
fancais	francais
cheerleeders	cheerleaders
brothers:	brothers
lyreics	lyrics
hàuser	häuser
poistion	positions
karreuche	karrueche
fscapture	capture
schueler.	schuler
eigentumswohnugn	eigentumswohnung
desirex	desire
jennifer.	jennifer
carrey's	carrey
festpaltten	festplatte
pornsars	pornstars
plüderausen	plüderhausen
kaorien	kalorien
aushandlung.	aushandlung
adnreas	andreas
kahrmanns	kahrmann's
anatpmy	anatomy
guardiens	guardians
defense4	defense
orgassmus	orgasmus
kristinna	kristanna
weisheitzähne	weisheitszähne
eisgeister	eisgeist
purpurner	purpurne
gemacht2	gemacht
bogazkentte	bogazkent
symtpome	symptome
hasswell	haswell
deektiv	detektiv
eiweißreichen	eiweißreiche
stuffig	stufig
savası	savasi
wthout	without
laboeuf	labeouf
flyknits	flyknit
dragenvale	dragonvale
(jacques	jacques
kadefugin	kadefungin
brustenzündung	brustentzündung
believen	believing
zwillingefrau	zwillingsfrau
ragonball	dragonball
olovia	olivia
ausgeleiherte	ausgeleierte
seasson	season
presleys	presley
gezura	gezuar
assessins	assassins
nebebwirkungen	nebenwirkungen
cassiopaia	cassiopeia
pornstarts	pornstars
gâteau	gateau
öyster	oyster
epsioden	episoden
montieth	monteith
mandes	mendes
rechtem	rechten
degeners	degeneres
filmstarta	filmstarts
ubungswehen	übungswehen
hyaluronsaure	hyaluronsäure
beachamp	beauchamp
holems	holmes
blutugen	blutung
winpern	wimpern
cypralex	cipralex
whasington	washington
fischigen	fischiger
schawnger	schwanger
mencester	manchester
www.jetz	www.jetzt
6.monate	monate
schowup	showup
chefcoch.de	chefkoch.de
berhain	berghain
venushugel	venushügel
schenkelhalsfrakturen	schenkelhalsfraktur
monsers	monsters
kupfernägel	kupfernagel
kurhaarfrisur	kurzhaarfrisur
snyonym	synonym
[harmoniepartikel]	harmoniepartikel
geografic	geographic
lennifer	jennifer
pfannekuchenhaus	pfannkuchenhaus
aandroid	android
schmetzen	schmerzen
revoire	revoir
unbuntu	ubuntu
sysnonyms	synonym
ocaklarda	ocaklar
lyricsd	lyrics
lyricsw	lyrics
chrity	christy
frisur,	frisuren
hürüyet	hürriyet
staendiger	ständiger
bikiini	bikini
diamind	diamond
beziheung	beziehung
whtiney	whitney
wehenfördernt	wehenfördernd
hillton	hilton
extere	externe
gonorrhö	gonorrhoe
minecradt	minecraft
dolomon	dolomo
evrosport	eurosport
weißere	weiße
kurzhaarfriesuren	kurzhaarfrisuren
baugartner	baumgartner
antother	another
yesilcayin	yesilcay
gszetesi	gazetesi
ohrlocher	ohrlöcher
rotische	erotische
blaeschen	bläschen
g´nathus	g'nathus
başlayan	baslayan
raucherlachs	räucherlachs
mobiliti	mobility
exhange	exchange
eğreti	egreti
jadepanter	jadepanther
kamersutra	kamasutra
yengecin	yengec
reisdent	resident
purdge	purge
direchtion	direction
baldur's	baldurs
hofreiten	hofreite
beautyful	beautiful
c1765nf	c1765nfw
difens	defense
epsiodes	episodes
ballika	balika
riffranke	riffkrake
mobafirre	mobafire
sexyest	sexiest
sockings	stockings
[fehlernummer:	fehlernummer:
revenge.	revenge
mgazine	magazine
anyones	anyone's
tearin	tearing
mary´s	mary's
epsidoe	episode
kurtzhaarfrisuren	kurzhaarfrisuren
tyalor	taylor
mattussek	matussek
kurzehaarfrisuren	kurzhaarfrisuren
americsn	american
mozarelle	mozzarella
erazer®	erazer
muslce	muscle
gangam	gangnam
duenner	dünner
schangerschaft	schwangerschaft
nohting	nothing
absetzt	absetzen
werkstundent	werkstudent
belezza	bellezza
bugunün	bugünün
billbord	billboard
pandarischen	pandarischer
www.frisuren.	www.frisuren
sexierst	sexiest
cerado	cerrado
schweissflecken	schweißflecken
moskowskije	moskowskie
büyükadada	büyükada
pinkelde	pinkelnde
istinyede	istinye
autsch'n!	autsch'n
sternzeiche	sternzeichen
alborán	alboran
flecke	flecken
munecraft	minecraft
hãuser	häuser
talkdrüse	talgdrüse
rikkus	rikku
linkem	linken
minecr4aft	minecraft
bombenentscharfung	bombenentschärfung
linksy	linksys
hauskuaf	hauskauf
blasenentzÜndung	blasenentzündung
schwangerachaft	schwangerschaft
morrissette	morissette
thirller	thriller
oroscopi	oroscopo
hontrop	höntrop
burnign	burning
schauspielet	schauspieler
boucin	bouncin
hilten	hilton
renaulz	renault
mittelanges	mittellanges
cocaine)	cocaine
angelian	angelina
chıld	child
casiopeia	cassiopeia
schwanferschaft	schwangerschaft
positiones	position
californiacation	californication
schuetzemann	schützemann
ubuntus	ubuntu
körpchengröße	körbchengröße
13wochen	wochen
kekilinin	kekilli
streisand,	streisand
v4.0.30319.	v4.0.30319
screeshot	screenshot
vangurdia	vanguardia
keynotes	keynote
elazığda	elazığ
trubute	tribute
w0hnung	wohnung
virual	virtual
siedereel	sidereel
hell:	hell
maffay,	maffay
übekeit	übelkeit
crouque	croque
bluetotth	bluetooth
unterleibsschmerz	unterleibsschmerzen
iparfümerie.de	iparfumerie.de
bobfrisure	bobfrisuren
shwazy	shwayze
fachangstellte	fachangestellte
sturdust	stardust
kurzhaarfrisuen	kurzhaarfrisuren
raffaeli	refaeli
practive	practice
lehmsal	lemsahl
ringelroteln	ringelröteln
fighers	fighters
schuchtern	schüchtern
feundin	freundin
bergsich	bergisch
langes,	langes
kurzhaaefrisur	kurzhaarfrisuren
igleasias	iglesias
unehelichem	uneheliches
hämorhoiden	hämorrhoiden
rikudō	rikudou
unchaind	unchained
pulveriser	pulverizer
analverkher	analverkehr
linsay	lindsay
klyrics	lyrics
konektivität	konnektivität
moorbrücker	moorbrück
kinopoli	kinopolis
(t.i.	t.i.
cell:	cell
lieberty	liberty
yourslef	yourself
would'nt	wouldn't
soerma	sperma
inspecto	expecto
eisenbaren	eisenbarren
bestbezahlter	bestbezahlte
noticas	noticias
sinsiter	sinister
rotungen	rötungen
goosip	gossip
angelmann	angelman
grösere	größere
ruckenschmerzen	rückenschmerzen
mégane	megane
tiempo,	tiempo
wohnng	wohnung
übelriechenden	übelriechender
coliflower	cauliflower
sezerin	sezer
burito	burrito
wwwnick.de	www.nick.de
2.festplatte	festplatte
creepypast	creepypasta
wohunung	wohnung
iptable	iptables
tortillia	tortilla
schattenprister	schattenpriester
menchú	menchu
pickrl	pickel
ovulationtest	ovulationstest
gardians	guardians
rammsrein	rammstein
ohrloecher	ohrlöcher
summarys	summary
wandsbe	wandsbek
naruzo	naruto
multimann	multiman
guitat	guitar
moebilierte	möblierte
wohnunhg	wohnung
shipuden	shippuuden
ausgeführt,	ausgeführt
reflexiven	reflexive
kurzhaarschitt	kurzhaarschnitt
eriklide	erikli
lyyrics	lyrics
zanderfilets	zanderfilet
mizzios	mizzio's
aelterer	älterer
sonenclar.	sonenclar
einmalkamera	einwegkamera
celebritie	celebrity
livetab	lifetab
seitencut	sidecut
will.i.am)	will.i.am
daugter	daughter
vladimier	vladimir
einnistungs	einnistung
roadhaus	roadhouse
kasasutra	karmasutra
horoslop	horoskop
duragı	duragi
lylrics	lyrics
valanyr	val'anyr
kumlucada	kumluca
beatyful	beautiful
horóscopo	horoscopo
kaifen	kaufen
theophilius	theophilus
aufgehoert	aufgehört
trennen,	trennen
kunzendorfer	kunzendorf
şehzade	sehzade
wigentumswohnung	eigentumswohnung
sportfreunden	sportfreunde
konradshoehe	konradshöhe
etsten	ersten
efendimizden	efendimizin
anison	aniston
counseler	counselor
habereri	haberleri
shippuuden:	shippuuden
antibiotoka	antibiotika
besenreisser	besenreiser
süleymanın	süleymanin
schaco	shaco
guzelbahce	güzelbahce
mobafier	mobafire
bowie's	bowie
bakıyor	bakiyor
tötliches	tödliches
naghty	naughty
fruchwasser	fruchtwasser
medicore	mediocre
grobporige	großporige
schumache	schumacher
suemmern	sümmern
ismail.	ismail
beşamel	besamel
wwwhüriyet	www.hurriyet
lanzberg	landsberg
impossibl	impossible
pessenger	passenger
nocking	knocking
sachsenhause	sachsenhausen
galatasaray.	galatasaray
autoversicherungs	autoversicherung
spaers	spears
wreaking	wrecking
unreinen	unreine
rogatzki	rogacki
pillenabsetzen	pillenabsetzung
osterstraße.	osterstraße
mínecraft	minecraft
message)	message
lustschloß	lustschloss
getraeumt	geträumt
lieblingsstellungen	lieblingsstellung
haarausfal	haarausfall
jackass:	jackass
tiramusu	tiramisu
restarurant	restaurant
scheidenentzündungen	scheidenentzündung
billboar	billboard
battlefront2	battlefront
witcher2	witcher
yangste	yangtse
tätärätätä	täterätätä
bardot,	bardot
ficiton	fiction
heroes2	heroes
mobarfire	mobafire
thausend	thousand
jennıfer	jennifer
república	republica
stillhuetchen	stillhütchen
wiohnung	wohnung
670u	n670u
papierkorp	papierkorb
abnehemen	abnehmen
hexenjaeger	hexenjäger
verwüsteten	verwüstete
cocosöl	kokosöl
billboars	billboard
überschriebenen	überschriebene
washingon	washington
lusttropfe	lusttropfen
jersery	jersey
gebaehrmutter	gebärmutter
william's	william
bleigiessen	bleigießen
hamorrhoiden	hämorrhoiden
chistmas	christmas
rasberry	raspberry
andorid	android
epsiodenguide	episodenguide
escabe	escape
kokosoel	kokosöl
schmwrzen	schmerzen
cashiragi	casiraghi
hackfleich	hackfleisch
guitsr	guitar
jetzzt	jetzt
exploere	explorer
untravelled	untraveled
francès	frances
argul's	arguls
www.nick.	www.nick
wohmumg	wohnung
weinachtsgeschenk	weihnachtsgeschenk
2.strich	strich
prinzessin,	prinzessin
restaurtant	restaurant
selbstbefriedigungs	selbstbefriedigung
wondeful	wonderful
yumurtasız	yumurtasiz
abehmen	abnehmen
gebährmutter	gebärmutter
polike	policke
fransigen	fransiger
sampionlar	sampiyonlar
zhau	zhao
somehting	something
eiegntumswohnung	eigentumswohnung
elisane	elisany
dragin	dragon
you ku.com	youku.com
maccarthy	mccarthy
klaufen	kaufen
schwangerschafz	schwangerschaft
volksbabk	volksbank
dimands	diamonds
sauthpark	southpark
versteuernden	versteuerndes
ultrogest	utrogest
mieteen	mieten
oberschenken	oberschenkel
c39:	c39
2.ohrloch	ohrloch
lennon,	lennon
grapewine	grapevine
killling	killing
spielen.	spielen
´wetter	wetter
jssica	jessica
shelock	sherlock
gewichtzunahme	gewichtszunahme
bulock	bullock
potters	potter
schraeger	schräger
zwischensummen	zwischensumme
zıraat	ziraat
sprinsteen	springsteen
mollaths	mollath
l´osteria	l'osteria
mitespiegel	mietspiegel
berlinin	berlin
gebährmutterschleimhaut	gebärmutterschleimhaut
layrics	lyrics
izlesen	izlesene
gabage	garbage
aufhellern	aufhellen
ajckson	jackson
kurzhaarfirsur	kurzhaarfrisur
aguiler	aguilera
mutand	mutant
ashrams	ashram
decks:	decks
abnehme	abnehmen
gosplay	cosplay
fructies	fructis
bescheid,	bescheid
hiberfile.sys	hiberfil.sys
sayarı	sayari
lyricsy	lyrics
shwangerschaft	schwangerschaft
treasue	treasure
anpisst	anpissen
punisch	punish
keuscheitsgürtel	keuschheitsgürtel
crepúsculo	crepusculo
(macklemore	macklemore
waframe	warframe
deliverence	deliverance
hbaerleri	haberleri
asssasins	assassins
caıllou	caillou
rihnanna	rihanna
pfeiffrisches	pfeiffersches
leistungindex	leistungsindex
orgasumus	orgasmus
picklige	pickelige
muhtessem	muhtesem
seanson	season
moring	morning
crimsons	crimson
gratel	gretel
eljazzira	aljazeera
mieten,	mieten
torjager	torjäger
littlle	little
wiederliche	widerliche
sharapowa	sharapova
night’s	night's
isntagram	instagram
swiched	switched
diggidy	diggity
seasoon	season
zombe's	zombes
zyklus,	zyklus
heisshunger	heißhunger
vladmir	vladimir
sticam	stickam
schwangerdchaft	schwangerschaft
sharazad	shahrazad
echevarría	echevarria
seeason	season
montgomery's	montgomery
fujifil	fujifilm
fashiion	fashion
recoery	recovery
austins	austin
jaiorunerk	jaiorunerks
drageon	dragon
makeover:	makeover
kubikcentimeter	kubikzentimeter
nagelhaerter	nagelhärter
everythin	everything
d'adele	d'adèle
laptop's	laptop
carott	carrot
blattgrun	blattgrün
maklemore	macklemore
kamusatra	kamasutra
safarie	safari
drooper	dropper
travoltas	travolta
anneroze	annerose
assasines	assassins
washngton	washington
pegorinos	pegorino's
virglio	virgilio
vibratur	vibrator
dynamo:	dynamo
standesamtlicher	standesamtliche
komodogen	komedogen
wonderland:	wonderland
sensesin	senses
flohamrkt	flohmarkt
olmpus	olympus
eigentuswohnung	eigentumswohnung
hekarim	hecarim
gökhanin	gökhan
flan`s	flans
falltüre	falltür
selbstbefriedigund	selbstbefriedigung
drgaon	dragon
ericcson	ericsson
schweisgeruch	schweißgeruch
pornstsr	pornstar
stulgang	stuhlgang
kleberreste	klebereste
rihanna's	rihanna
wetteronlien	wetteronline
kostzenlose	kostenlos
nauhty	naughty
tatstatur	tastatur
beleive	believe
trődelmarkt	trödelmarkt
thingpad	thinkpad
superntural	supernatural
excahnge	exchange
lyricvs	lyrics
slomid	solomid
netzclub.	netzclub
hirschen,	hirschen
halzschmerzen	halsschmerzen
4.staffel	staffel
trentige	trendige
esperenza	esperanza
borissov	borisov
averngers	avengers
tensei:	tensei
baessler	bässler
aniston,	aniston
nuvaringe	nuvaring
aninmal	animal
geographik	geographic
auskauf	hauskauf
everythig	everything
hunter4	hunter
mieiten	mieten
indespicable	despicable
gazetesi,	gazetesi
immoblienen	immobilien
geschochten	geschichten
ultimaten	ultimate
frisiuren	frisuren
angalina	angelina
wärend	während
partnermonat	partnermonate
mifegyn	mifegyne
weersverwachtingen	weersverwachting
skyrim,	skyrim
kaufdn	kaufen
ausgeleihert	ausgeleiert
franzig	fransig
penepole	penelope
justim	justin
beautigul	beautiful
simspon	simpson
màdchen	mädchen
moraska	mooraska
gemüsebeete	gemüsebeet
episonden	episode
cupckes	cupcakes
cleander	cleaner
winehous	winehouse
online:	online
hämoroiden	hämorrhoiden
bassinger	basinger
ebtfernen	entfernen
mediast	mediaset
whatsappp	whatsapp
mypassport	passport
mâdchen	mädchen
kamaasutra	kamasutra
lyrtics	lyrics
vaterfreude	vaterfreuden
icarly.	icarly
mamutovit	mahmutovit
spaghettie	spaghetti
maerican	american
beyoncr	beyonce
legaue	league
tratorria	trattoria
maraih	mariah
cayirovada	cayirova
hassliche	hässliche
comdedy	comedy
tanrıyar	tanriyar
mieteohnung	mietwohnung
convertiseur	convertisseur
juwelierfassung	juweliersfassung
hewitt,	hewitt
bloombeg	bloomberg
passanger	passenger
erwischt.	erwischt
gamecribs	gamecrib
orgssmus	orgasmus
chronicals	chronicles
2.geburt	geburt
avengers:	avengers
tavsanlida	tavsanli
eingentumwohnung	eigentumswohnung
blinktron	blingtron
mietten	mieten
hämorroiden	hämorrhoiden
kolliken	koliken
wohnunfen	wohnung
harschnitt	haarschnitt
rückgangig	rückgängig
coomand	command
elite:	elite
konzentrationsschwaeche	konzentrationsschwäche
formlen	formeln
filmstarzs	filmstarts
sacrafice	sacrifice
ertsen	ersten
prakticom	prakti.com
rueckkehr	rückkehr
millıyet	milliyet
harmon's	harmon
andwoord	antwoord
kurzgaarfrisuren	kurzhaarfrisuren
preussenpark	preußenpark
anzukurbeln	ankurbeln
billaboard	billboard
stream.to/	stream.to
semenowitsch	semenovich
posisyonlari	pozisyonlari
nigggas	niggas
ferullo	ferullos
flüssigen	flüssigem
nuetzliche	nützliche
stuhlfarben	stuhlfarbe
gazetesii	gazetesi
alista	alistar
defaul	default
californacation	californication
hayeller	hayaller
pharrel	pharrell
jounral	journal
häusee	häuser
diamnds	diamonds
schangerschaftstest	schwangerschaftstest
beautful	beautiful
leageue	league
octonom	octomom
kutsher	kutcher
doon?	doon
havent	haven't
vermächnis	vermächtnis
ar5007ug	ar5007eg
trej	trek
touchn	touch'n
unspezifischen	unspezifische
mobafire.	mobafire
lyricsa	lyrics
faithul	faithful
bindungsängste	bindungsangst
schwangersxhaft	schwangerschaft
sextaoe	sextape
deeptroth	deepthroat
pegeant	pageant
offies	office
maybellin	maybelline
kaltwachsen	kaltwachs
muttermahl	muttermal
verstopft,	verstopft
machbook	macbook
meraklı	merakli
güllükte	güllük
fighters,	fighters
kurzharfrisur	kurzhaarfrisur
winter:	winter
tenuarte	tenuate
inazum	inazuma
braeune	bräune
bartender4	bartender
aufhelle	aufhellen
nebenwirkingen	nebenwirkungen
ovgude	ovguide
haesslich	hässlich
grafikarten	grafikkarten
crépin	crepin
sexiesr	sexiest
garten's	garten
keiserschnitt	kaiserschnitt
acsend	ascend
wohnunmg	wohnung
einführe	einführen
perfecr	perfect
lborg,	Ålborg,
denfense	defense
carrott	carrot
pferdeleckerli	pferdeleckerlies
converster	converter
autorader	autotrader
willkommenspakete	willkommenspaket
alchmist	alchemist
schlaemmer	schlämmer
ovolutionstest	ovulationstest
gokujou!!	gokujou
kauafen	kaufen
ferrah	farrah
expolorer	explorer
justın	justin
nashors	nashor's
fläschen	fläschchen
wohnunhen	wohnungen
marktcom.	marktcom
branson's	branson
affektiven	affektive
(einfach)	einfach
eierstock,	eierstock
hikayelri	hikayeleri
fachitas	fajitas
larry:	larry
ascherregen	ascheregen
ametican	american
watson.	watson
schwangerschaftsuebelkeit	schwangerschaftsübelkeit
prettty	pretty
eierstocken	eierstöcken
benchmarl	benchmark
bauhütten	bauhütte
serienmails	serienmail
masskonfektion	maßkonfektion
etreutes	betreutes
emipre	empire
wonungh	wohnung
madelsabend	mädelsabend
kohletablette	kohletabletten
scöner	schöner
hotsport	hotspot
ranult	renault
allgemeinwissens	allgemeinwissen
herobrines	herobrine's
milchfluß	milchfluss
condolências	condolencias
nauthy	naughty
blooberg	bloomberg
zayıflatan	zayiflatan
emfindliche	empfindliche
dalgas	dalkas
licherfelde	lichterfelde
stattham	statham
realtiy	reality
alonsos	alonso
galixy	galaxy
skyrims	skyrim
überraschungen	überraschung
entzundete	entzündete
pronoseite	pornoseiten
architectual	architectural
imagin	imagine
lycost	lycos
eigentumawohnung	eigentumswohnung
dailymotionen	dailymotion
garmische	garmisch
ecplorer	explorer
bariss	barriss
wildflügelbrust	wildgeflügelbrust
bauchumpfang	bauchumfang
halleluhjah	hallelujah
hautausschläge	hautausschlag
laconda	locanda
sqllite	sqlite
kurzhar	kurzhaar
embrassing	embarrassing
ereglide	eregli
stelungen	stellungen
radioactiv	radioactive
bauspeicheldrüse	bauchspeicheldrüse
anistons	aniston
saldaña	saldana
justib	justin
ohnung	wohnung
kamastura	kamasutra
veyselin	veysel
tüncina	tuncina
toshibas	toshiba
stewat	stewart
stellungem	stellungen
ssmsung	samsung
paarthunax	paarthurnax
löscheb	löschen
krauterblut	kräuterblut
kintops	kintop
herzen:	herzen
heldt:	heldt
crriere	corriere
bryonce	beyonce
bibical	biblical
basalttemperatur	basaltemperatur
autotraders	autotrader
augumented	augmented
yazdım	yazdim
minecraft6	minecraft
butterplaetzchen	butterplätzchen
yotk	york
assoult	assault
schönheitsreperaturen	schönheitsreparaturen
gehaltsgespräche	gehaltsgespräch
chrystical	crystical
kauifen	kaufen
samurai:	samurai
tlistbox	listbox
kurdlar	kurtlar
wohnungrn	wohnungen
hauskaif	hauskauf
rsident	resident
opripamol	opipramol
gastby	gatsby
çivril	civril
spearse	spears
laycos	lycos
harvst	harvest
ly<rics	lyrics
subnetzmasken	subnetzmaske
musterhausdorf	musterhauspark
joiride	joyride
boncing	bouncing
backett	beckett
fruhchen	frühchen
telecino	telecinco
oralce	oracle
stargate:	stargate
gibbed's	gibbed
lyriccs	lyrics
wachsfleck	wachsflecken
selbstbefriedigug	selbstbefriedigung
parenterol	perenterol
selbbefriedigung	selbstbefriedigung
sa,sung	samsung
inmülheim	mülheim
siderrel	sidereel
jungling	jungle
ouji:	ouji
autotrder	autotrader
here`s	here's
aussicht,	aussicht
screenshoot	screenshot
rtl1025	rtl102.5
monitir	monitor
leandros,	leandros
esenköyde	esenköy
daquiri	daiquiri
vrmieten	mieten
emulato	emulator
embolien	embolie
justtin	justin
grundstùck	grundstück
gamestar.	gamestar
m.tumblr	tumblr
hearthgold	heartgold
fireall	firewall
johannsson	johansson
durschnittsalter	durchschnittsalter
5cheats	cheats
dominien	dominion
laechelt	lächelt
huurriyet	hurriyet
billabord	billboard
svhwangerschaft	schwangerschaft
häßlichste	hässlichste
kopfumpfang	kopfumfang
almoust	almost
unleashed:	unleashed
fehlgeburt,	fehlgeburt
beziehungsängste	beziehungsangst
liveleaks	liveleak
2.staffel	staffel
tangeld	tangled
beyomce	beyonce
pasttime	pastime
softly,	softly
glatteisen	glätteisen
kontakt.	kontakt
rezpete	rezepte
schõne	schöne
pruple	purple
aresenal	arsenal
boregi	böregi
jeninifer	jennifer
tatum's	tatum
eisprug	eisprung
immbbilien	immobilien
adventrue	adventure
stoehnen	stöhnen
längsrille	längsrillen
crubile	crucible
lätitia	laetitia
inkumda	inkumu
coulombsche	coulombsches
abführender	abführende
potter1	potter
d’autet	d'autet
mainsteam	mainstream
agony.	agony
peolple	people
cantonnais	cantonais
goalpost	goalposts
godfather:	godfather
geriche	gerichte
acuuweather	accuweather
assasin's	assassin's
liitle	little
eiersprung	eisprung
frizuren	frisuren
hottets	hottest
ultimat	ultimate
ımmobilien	immobilien
fallons	fallon
stwart	stewart
turtels	turtles
iphotos	iphoto
should´ve	should've
dtektiv	detektiv
legeds	legends
www.moster	www.monster
kaufemn	kaufen
nassage	massage
strenchen	strähnchen
meiten	mieten
verwönen	verwöhnen
recomendation	recommendation
haarfrisuren,	haarfrisuren
year´s	year's
whashington	washington
schildrüsentabletten	schilddrüsentabletten
gefuhle	gefühle
apparation	apparition
portabe	portable
lasejet	laserjet
terrastation	terastation
vaginalpils	vaginalpilz
haether	heather
yumuşak	yumusak
filmstrats	filmstarts
angeschwollene	geschwollene
virtualnight	virtualnights
tisdale's	tisdale
frisüren	frisuren
gazezesi	gazetesi
grössere	größere
verleibt	verliebt
suresini	suresi
wesleys	wesley
oympus	olympus
frwund	freund
gebährmutterhals	gebärmutterhals
abführendes	abführende
eiweissshakes	eiweißshakes
ahzidal's	ahzidal
tatort:	tatort
diamons	diamonds
jetztspielen.	jetztspielen
sidreel	sidereel
schwangersvhaft	schwangerschaft
heantai	hentai
liftab	lifetab
schmwerzen	schmerzen
radikla	radikal
festpltte	festplatte
errigierter	erigierter
sengin	zengin
lässtige	lästige
keciörende	keciören
pefect	perfect
volkdorf	volksdorf
disnex	disney
jackman,	jackman
wohnunng	wohnung
cantonette	cantonnet
vibtator	vibrator
schlaefe	schläfe
limasoll	limassol
gamschen	gamaschen
einfersüchtig	eifersüchtig
bechamelle	bechamel
reiswaffel	reiswaffeln
www.schöner	www.schoener
systemstartreperatur	systemstartreparatur
offentlichkeit	öffentlichkeit
dviant	deviant
3monats	monats
season3	season
wehenfoerdernd	wehenfördernd
oragami	origami
transelvanien	transsilvanien
orasmus	orgasmus
senerade	serenade
lyrics\	lyrics
ağlayan	aglayan
kakasutra	kamasutra
soical	social
festolatte	festplatte
selbstbefridigungs	selbstbefriedigung
beziehnung	beziehung
fettflecke	fettflecken
schlafstorungen	schlafstörungen
gebarmutterhalskrebs	gebärmutterhalskrebs
barbarra	barbara
sorgerecht,	sorgerecht
wohung	wohnung
darkorit	darkorbit
kostebek	köstebek
rechnernamen	rechnername
poschmerzen	schmerzen
naughy	naughty
shcnell	schnell
morissette,	morissette
zevixschleim	zervixschleim
warend	während
teqila	tequila
jailbreal	jailbreak
ımmowelt	immowelt
gelblichen	gelblicher
anerican	american
uebungswehen	übungswehen
behemoths	behemoth
possibl	possible
wohnmung	wohnung
westwoods	westwood
realeases	releases
pharall	pharrell
mevericks	mavericks
ileven	eleven
krzhaarfrisuren	kurzhaarfrisuren
gar´lok	gar'lok
selim'den	selimden
logitech®	logitech
loewemann	löwemann
horocopo	horoscopo
adwanced	advanced
ereignisprotokolle	ereignisprotokoll
androind	android
jazzira	jazeera
ericcsson	ericsson
dawsen	dawson
errektion	erektion
resaturants	restaurant
eigentumswohmung	eigentumswohnung
tehtering	tethering
filmstarst	filmstarts
vetrova	vjetrova
şabaniye	sabaniye
ich8do	ich8m
hürrüyet	hürriyet
umwandel	umwandeln
toplles	topless
realistics	realistic
birlesim	birlesimi
scharmhaare	schamhaare
überlebt!	überlebt
hösschen	höschen
minecfrat	minecraft
dughter	daughter
pornoseitem	pornoseiten
monsanto,	monsanto
kauflanf	kaufland
grossparkplatz	großparkplatz
heidelburg	heidelberg
dariks	darik's
gümüldürde	gümüldür
schulmächen	schulmädchen
beuchamp	beauchamp
punischen	punische
harrfrisuren	haarfrisuren
wondring	wondering
fabricca	fabbrica
21monate	monate
thirwall	thirlwall
grossflächiger	großflächiger
bikinni	bikini
macadams	mcadams
schuechtern	schüchtern
timline	timeline
mexicaner	mexikaner
schwangerschaf	schwangerschaft
snicket's	snicket
bambegr	bamberg
naucheim	nauheim
herzrhytmusst	herzrhythmusst
eigentimswohnungen	eigentumswohnung
klorien	kalorien
neiuwsblad	nieuwsblad
fithead	futhead
hattaway	hathaway
excorcist	exorcist
possebil	possible
traeumt	träumt
spongo	sponge
loescht	löscht
kurzhaarfrisr	kurzhaarfrisur
fingernaegeln	fingernägeln
ceterezin	cetirizin
smasung	samsung
bungswehen	übungswehen
donneretter	donnerwetter
ermieten	mieten
tycoon2	tycoon
hunziger	hunziker
hildabrötle	hildabrötchen
timberlacke	timberlake
drachenmaedchen	drachenmädchen
zufuttern	zufüttern
unknwon	unknown
cumbulun	cumbul
signalstaerke	signalstärke
hoppípolla	hoppipolla
yazildi	yazildigi
britnay	britney
scoocer	soccer
sohnung	wohnung
borthel	brothel
clooney,	clooney
animalischen	animalischer
wohnugne	wohnungen
zomnie	zombie
graustreifs	graustreif
/gamemode	gamemode
wohnu8ng	wohnung
verident	verdient
(komm	komm
kaiserschitt	kaiserschnitt
heaart	hearts
schmerzrn	schmerzen
swanepool	swanepoel
quarkmasken	quarkmaske
yimpaş	yimpas
sparksnotes	sparknotes
mellenkamp	mellencamp
hepatits	hepatitis
schleimpfropfs	schleimpfropf
enripue	enrique
kurzhaafrisur	kurzhaarfrisur
schwangerschsft	schwangerschaft
soundlink®	soundlink
wohmungen	wohnung
schwangrrschaft	schwangerschaft
seleena	selena
mechantroniker	mechatroniker
fruchbarkeit	fruchtbarkeit
wheigt	weight
scrubs,	scrubs
rinderbaeckchen	rinderbäckchen
advebture	adventure
minevraft	minecraft
diomonds	diamonds
kurzhaarfrisurem	kurzhaarfrisuren
verhartung	verhärtung
turner:	turner
werkstuden	werkstudent
meßplatz	messplatz
milchpumpen	milchpumpe
fimstarts	filmstarts
feuerwerkssterne	feuerwerksstern
cocunut	coconut
stagnetti	stagnettis
beliebe	believe
turşusu	tursusu
entjungfernt	entjungfert
immobioien	immobilien
dünnere	dünne
whtasapp	whatsapp
gazetezi	gazetesi
zeppelin,	zeppelin
york'ta	yorkta
torschutzen	torschützen
lebsian	lesbian
sobgtext	songtext
milliyet.	milliyet
wohnungene	wohnungen
umwanden	umwandeln
oerdinger	oerding
lolking.	lolking
lauwerk	laufwerk
sexsellungen	sexstellungen
cahnnel	channel
porstars	pornstars
chlormadion	chlormadinon
protien	protein
insemation	insemination
leonovo	lenovo
bizarrer	bizarre
parlamentes	parlaments
piggis	piggies
Öfkeli	öfkeli
lymphknote	lymphknoten
shannone	shannon
directo.	directo
synonims	synonym
mierten	mieten
flechtfisuren	flechtfrisuren
blaehungen	blähungen
ninjago.	ninjago
deppenbusch	depenbusch
songtect	songtext
grönemeyer,	grönemeyer
zervisschleim	zervixschleim
carliforniacation	californication
oddworld:	oddworld
chestnutt	chesnutt
schwangerschaftdiabetes	schwangerschaftsdiabetes
aenema	aenima
mietwohnunegn	mietwohnungen
bizzarer	bizarre
entenbrustfilets	entenbrustfilet
monoploy	monopoly
bekomnt	bekommt
apflekuchen	apfelkuchen
skxrim	skyrim
l'thyrox	thyrox
citalopran	citalopram
arguilera	aguilera
gucler	gücler
huaskauf	hauskauf
riechts	riecht
hyaleron	hyaluron
haxnhaus	haxenhaus
firerwall	firewall
hero3:	hero3
druckgefuehl	druckgefühl
(zwette	zwette
kikilli	kekilli
olymus	olympus
drüber,	drüber
tastaturen	tastatur
ihanna	rihanna
grey`s	grey's
thethering	tethering
schischa	shisha
weißachalm	weissachalm
palthrow	paltrow
kinecraft	minecraft
haarverdichtungen	haarverdichtung
citites	cities
chatterly	chatterley
bolgnese	bolognese
anchorman:	anchorman
akkkorde	akkorde
blutdruck,	blutdruck
orcale	oracle
samstung	samsung
stuhgang	stuhlgang
beautuful	beautiful
coskunun	coskun
anmachspruche	anmachsprüche
bonefire	bonfire
basuke	basket
gragons	dragons
schuhmanns	schumanns
korpertemperatur	körpertemperatur
susannenstrasse	susannenstraße
dauhter	daughter
(journaled)	journaled
galatasay	galatasaray
ultraschall,	ultraschall
btooom!	btooom
erikson's	erikson
eigentumswohning	eigentumswohnung
braunungscreme	bräunungscreme
abnehmn	abnehmen
rasifal	rashifal
rachenentzuendung	rachenentzündung
gysbert	gisbert
magazın	magazin
viamichelin.	viamichelin
zaepfchen	zäpfchen
schwangeschaft	schwangerschaft
enderportalrahmen	endportalrahmen
behsat	behzat
eurospirt	eurosport
angelna	angelina
britnes	britney
hiddelston	hiddleston
kindbewegung	kindsbewegung
galaaxy	galaxy
nierenentzuendung	nierenentzündung
pfeiffersche	pfeiffersches
cammeltoe	cameltoe
schambeinschmerz	schambeinschmerzen
you´re	you're
synonys	synonym
paepstin	päpstin
tatsatur	tastatur
alptraeume	alpträume
schoensten	schönsten
werstudent	werkstudent
hummous	hummus
kaufden	kaufen
everheart	everhart
javanse	javaanse
crèpes	crepes
blommberg	bloomberg
mustafa's	mustafa
remeber	remember
minaj's	minaj
erketion	erektion
dünneres	dünnes
lyricas	lyrics
achievemnt	achievement
stuhlgang,	stuhlgang
tatums	tatum
shadesof	shades
kadayıf	kadayif
wwohnung	wohnung
wwwjetzt	www.jetzt
relases	release
jannice	janice
wimpernverlängerungen	wimpernverlängerung
schnaze	schanze
winter´s	winter's
spatacus	spartacus
crimina	criminal
kamatsura	kamasutra
erfect	perfect
eiegentumswohnung	eigentumswohnung
geschichtem	geschichten
shakira's	shakira
clifornia	california
tyrells	tyrell
8.staffel	staffel
urogest	utrogest
ammanda	amanda
samsing	samsung
lyricys	lyrics
eltribuno	tribuno
cheseburger	cheeseburger
geoforce	geforce
moblierte	möblierte
offenbache	offenbach
o´loughlin	o'loughlin
achorde	chords
mirrirs	mirrors
kopiergeschützter	kopiergeschützte
nations:	nations
marmorkuche	marmorkuchen
collosseo	colosseo
breackers	breakers
juenger	jünger
explorerer	explorer
morriso	morrison
hendrix:	hendrix
broekn	broken
guillaume,	guillaume
asymetrischer	asymmetrischer
^monster	monster
8.monate	monate
lyrrics	lyrics
moskova'nin	moskovanin
voliber	volibear
tenacous	tenacious
satharion	sartharion
kardioselektiver	kardioselektive
immobilien;	immobilien
dokumentenstruktur	dokumentstruktur
colpix	coolpix
sondakka	sondakika
nothin’	nothing
eigenttumswohnung	eigentumswohnung
tvstar	star
sommersproßen	sommersprossen
slaughter,	slaughter
mietan	mieten
muskelschwaeche	muskelschwäche
moebelierte	möblierte
mansons	manson
samsunf	samsung
wolverine:	wolverine
trödelmarkt.	trödelmarkt
eigentumswohnng	eigentumswohnung
your´re	you're
benetar	benatar
mittelohrentzuendung	mittelohrentzündung
nohing	nothing
interuptus	interruptus
hiddden	hidden
schwanderschaft	schwangerschaft
trailerparks	trailerpark
heavem	heaven
haberlleri	haberleri
domingão	domingao
dateiein	dateien
intenetara.	internetara
instinc	instinct
analfisur	analfissur
kaufenn	kaufen
macklemore,	macklemore
supernaural	supernatural
zuckerelritzen	zuckerelritze
möbilerte	möblierte
soltan3	soltan
kangalı	kangal
wwwjetz	www.jetzt
magezin	magazin
koenigshardt	königshardt
androidtm	android
2.schwangerschaft	schwangerschaft
miezwohnung	mietwohnung
scotch,	scotch
krausige	krause
weissheitszähne	weisheitszähne
maverricks	mavericks
verschworung	verschwörung
eigentumswognung	eigentumswohnung
wmware	vmware
upcomming	upcoming
bestimmtem	bestimmten
semesterapparate	semesterapparat
nachtway	nachtwey
elternzeit,	elternzeit
hungtington	huntington
//www.callofduty.com/mw3/status	www.callofduty.com/mw3/status
rupauls	rupaul's
croniken	chroniken
zimmwe	zimmer
landruth	landrut
vitanin	vitamin
uktimate	ultimate
postition	position
ueberfordert	überfordert
kaufen;	kaufen
ramstien	ramstein
eigentumswwohnung	eigentumswohnung
linskey	lynskey
rmiete	mieten
mundwinckel	mundwinkel
ersteb	ersten
v4.030319	v4.0.30319
tcombobox	combobox
lilltle	little
kuerbiscremesuppe	kürbiscremesuppe
whinhouse	winehouse
kurzhaarfristuren	kurzhaarfrisuren
schanett	janett
samdung	samsung
muffings	muffins
familyfilter	familienfilter
etheral	ethereal
tso's	tso
steißbeinschmerz	steißbeinschmerzen
ringlé	ringle
blässchen	bläschen
samsnung	samsung
lägendäre	legendäre
eigentumsswohnung	eigentumswohnung
dadele	d'adèle
spartacus,	spartacus
wohningen	wohnungen
immoiblien	immobilien
schmeren	schmerzen
spriengfield	springfield
doghter	daughter
beyonce's	beyonce
hochwasse	hochwasser
shojou	shoujo
frieden!	frieden
tattooes	tattoo
spartcus	spartacus
nasenschleimhäute	nasenschleimhaut
schwangershcaft	schwangerschaft
kyrotransfer	kryotransfer
nebnwirkungen	nebenwirkungen
eregtion	erektion
sokakalr	sokaklar
selbtbefriedigung	selbstbefriedigung
permisul	permis
schmerzne	schmerzen
lockhardt	lockhart
laaste	laatste
testaurants	restaurant
habertuerk	habertürk
twicth	twitch
chwanger	schwanger
ildirda	ildir
eveything	everything
eisenzwerge	eisenzwerg
whore's	whores
citizin	citizen
mühteşem	muhteşem
assasains	assassins
crytsal	crystal
lillte	little
schwâbisch	schwäbisch
ziwohnung	wohnung
bootmrg	bootmgr
runnign	running
repubic	republic
kaffeefleck	kaffeeflecken
hämorrhiden	hämorrhoiden
mitenin	mieten
trojaners	trojaner
antriebsschienen	antriebsschiene
vigantolette	vigantoletten
konigsbach	königsbach
kharazan	karazhan
befiedigen	befriedigen
metacrtic	metacritic
naurto	naruto
unötige	unnötige
straehnen	strähnen
leukoplakien	leukoplakie
d'objets	objets
phosporicum	phosphoricum
sarması	sarmasi
gebaermutter	gebärmutter
7.psychos	psychos
ruess)	ruess
weihnachtsplätchen	weihnachtsplätzchen
schwangerschafr	schwangerschaft
www.adomfm	www.adom
crafte	craftet
filmsarts	filmstarts
spaltenbreiten	spaltenbreite
hunzinker	hunziker
wimperverlängerung	wimpernverlängerung
itinéraires	itineraire
fubktioniert	funktioniert
affaere	affäre
bukkit.	bukkit
neloths	neloth
scheidenpilze	scheidenpilz
zaertlichkeit	zärtlichkeit
angalis	anglais
mådchen	mädchen
klärchens	clärchens
celebities	celebrities
hoefingen	höfingen
underworld:	underworld
renaulkt	renault
woudnt	wouldn't
reforginator	reforgenator
einmalkameras	einwegkameras
dohertys	doherty
schône	schöne
korkusus	korkusuz
frisurentends	frisurentrend
ecplise	eclipse
beklerkene	beklerken
hosuton	houston
rassiert	rasiert
swollowed	swallowed
celebtities	celebrities
detektic	detektiv
rollings	rolling
komedogene	komedogen
fleischbaellchen	fleischbällchen
heimnetzgruppen	heimnetzgruppe
wwwbabi	www.babi
ulltimate	ultimate
lookbook.	lookbook
pulverfaß	pulverfass
remmeber	remember
horsturz	hörsturz
crumpy	grumpy
selema	selena
schmezen	schmerzen
kofteci	köfteci
unterleibschmerzen	unterleibsschmerzen
schweisshände	schweißhände
wiedergabelisten	wiedergabeliste
mierwohnung	mietwohnung
schwangerschadt	schwangerschaft
abspritze	abspritzen
nebewirkungen	nebenwirkungen
daneel	danneel
rihanna.	rihanna
shuppen	schuppen
kamasitra	kamasutra
sondaka	sondakika
dreanor	draenor
delavigne	delevingne
runterholt	runterholen
hopless	hopeless
guzelcamli	güzelcamli
victoious	victorious
bieebr	bieber
battlegroundtarget	battlegroundtargets
kampfhaustierbandagen	kampfhaustierbandage
debbuging	debugging
´wohnungen	wohnungen
season6	season
morther	mother
satyameva	satyamev
mish's	mish
selbstbefreidigung	selbstbefriedigung
sabinden	sahibinden
basalthemperatur	basaltemperatur
zombies,	zombies
tarallini	taralli
radioacktiva	radioactiva
huruyet	hurriyet
copperhouse	copperhaus
securtity	security
multivers	multiverse
herzigová	herzigova
watso	watson
persuit	pursuit
ûbelkeit	übelkeit
silcence	silence
recovry	recovery
minecrafz	minecraft
luisada	lusiada
kammerjägerei	kammerjäger
farrell's	farrell
eigentumseohnung	eigentumswohnung
d'avrupa	avrupa
bandicot	bandicoot
wohnungne	wohnungen
filmlerini	filmleri
ahberleri	haberleri
sonnebank	sonnenbank
extencions	extensions
oğlan	oglan
restauarnt	restaurant
www.gangam	www.gangnam
́minecraft	minecraft
einsturzende	einstürzende
garfunkle	garfunkel
jugetes	juguetes
eritische	erotische
gozleme	gözleme
artıran	artiran
tiransfer	transfer
dongtext	songtext
velafaxin	venlafaxin
oickel	pickel
lyerics	lyrics
higgings	higgins
headsets	headset
blankenes	blankenese
schmiede,	schmiede
erenerin	erener
cyberjack®	cyberjack
smiling,	smiling
marvin's	marvins
zugenomen	zugenommen
verything	everything
tomight	tonight
schwagner	schwanger
aspirer	aspire
weißwürste	weißwurst
senturier	seinturier
mietwihnungen	mietwohnungen
autofahrten	autofahrt
ponstars	pornstars
brmeen	bremen
firwall	firewall
hriyet	hurriyet
9.staffel	staffel
/delete	delete
überstreckung	überstrecken
cicket	cricket
dooors2	dooors
beschäftigungsverbote	beschäftigungsverbot
gebarmutterhals	gebärmutterhals
ni**gas	niggas
dragomball	dragonball
visuall	visual
canonscan	canoscan
fruchtsäurepeelings	fruchtsäurepeeling
schwangerschat	schwangerschaft
sasmung	samsung
hämorrhoide	hämorrhoiden
darmverschluß	darmverschluss
kzrzhaarfrisuren	kurzhaarfrisuren
monsterstunt	monsterstunts
gefuehle	gefühle
gensis	genesis
ruchtig	richtig
achselschweiss	achselschweiß
kurzharfrisuren	kurzhaarfrisuren
galatica	galactica
didimden	didimde
assassin´s	assassins
cheeleader	cheerleader
spawneier	spawner
ipossible	impossible
rechtsabteilungen	rechtsabteilung
lyirics	lyrics
whataapp	whatsapp
doerfles	dörfles
gofeminine	gofeminin
eigentumawohnungen	eigentumswohnung
criminial	criminal
athlets	athletes
stechn	stechen
/ebersbach	ebersbach
schmlippen	schamlippen
jeesica	jessica
hallejuha	hallelujah
daghter	daughter
kasumatra	kamsutra
o’donoghue	o'donoghue
mercenery	mercenary
maimes	m'aimes
extentions	extensions
freisuren	frisuren
verkuerzt	verkürzt
pasticera	pasticcera
kalorinen	kalorien
commanden	command
kobalin	kobal
tayloe	taylor
friedirchshain	friedrichshain
des´ree	des'ree
dchwangerschaft	schwangerschaft
stimmulieren	stimulieren
borthers	brothers
restauarant	restaurant
nymphmaniac	nymphomaniac
tlyrics	lyrics
kurzhaarfrisut	kurzhaarfrisuren
spermer	sperma
unthethered	untethered
mietwohnunger	mietwohnungen
mediase	mediaset
wiedrr	wieder
ienstein	einstein
^curse	curse
sxhwangerschaft	schwangerschaft
www.monsta	www.monster
4195fn	4195fw
mullholand	mulholland
kamastra	kamasutra
10wochen	wochen
fallour	fallout
harrschnitte	haarschnitte
esenyurta	esenyurt
justion	justin
größer,	größer
fizzgeraldo	fitzgeraldo
entebrust	entenbrust
camaltoe	cameltoe
zugriffrechte	zugriffsrechte
wimmpern	wimpern
talbuks	talbuk
tagebuch3	tagebuch
lovato,	lovato
lerthe	lehrte
herzmuskelentzuendung	herzmuskelentzündung
bluestack	bluestacks
calikuşu	calikusu
wantes	wanted
changin	changing
hberleri	haberleri
berguzar	bergüzar
yizyil	yüzyil
weigentumswohnung	eigentumswohnung
perianalthrombosen	perianalthrombose
albtraeume	albträume
wallpaper*	wallpaper
gutverdienende	bestverdienende
gokbakar	gökbakar
hearz	heart
abstille	abstillen
schnellle	schnelle
eucerine	eucerin
männder	männer
xlsemanal	semanal
blahbauch	blähbauch
siderell	sidereel
gigybyte	gigabyte
horoskop,	horoskop
schwangerschft	schwangerschaft
ungewünschte	unerwünschte
hurriyert	hürriyet
ovulationstests	ovulationstest
tamasutra	kamasutra
tribuene	tribüne
überstimmulation	überstimulation
tonoght	tonight
streifenfreies	streifenfrei
bhart	bharat
ultraschalls	ultraschall
vaginalpilze	vaginalpilz
pemala	pamela
civilization:	civilization
samsunh	samsung
prnstars	pornstars
donenrwetter	donnerwetter
anschreibung	anschreiben
sherzinger	scherzinger
futjead	futhead
downblose	downblouse
liittle	little
dingtest	songtext
ascensions	ascension
vanitiy	vanity
undown	undone
synonimus	synonym
liebeskumme	liebeskummer
johhny	johnny
erkaeltung	erkältung
bulumie	bulimie
vhonung	wohnung
doktorspiel	doktorspiele
dalari	dallari
schlukt	schluckt
blackberry.	blackberry
abottle	bottle
feuermale	feuermal
bauchnarbel	bauchnabel
oblibion	oblivion
ibirahim	ibrahim
filstarts	filmstarts
heishunger	heißhunger
fotofile	photofile
bilerzik	bilezik
schtelungen	stellungen
frisurem	frisuren
frundin	freundin
analverkerh	analverkehr
hourglas	hourglass
shibinden	sahibinden
oblivision	oblivion
belkeit	übelkeit
suechtig	süchtig
seaons	season
mutterschaftgeld	mutterschaftsgeld
äthoxysklerol	aethoxysklerol
tarrantino	tarantino
springfiled	springfield
hornhautverkruemmung	hornhautverkrümmung
ausgedrückter	ausgedrückte
bundelsiga	bundesliga
geldorf	geldof
filmtarts	filmstarts
gofemini	gofeminin
pharell	pharrell
naruti	naruto
season)	season
aschegrauen	aschegrauer
erothische	erotische
feninim	feminin
samsaung	samsung
epiliert	epilieren
solomid.	solomid
paraniod	paranoid
grunschtück	grundstück
almanache	almanach
hilton,	hilton
İntikam	intikam
béchamel	bechamel
kaufwen	kaufen
12apostel	apostel
zaehneknirschen	zähneknirschen
vogtsdorf	voigtsdorf
reicht´s	reichts
snooki's	snooki
pferdige	pferde
vegas:	vegas
kaiseschnitt	kaiserschnitt
gallaxy	galaxy
celebryties	celebrities
zäpchen	zäpfchen
sensorschienen	sensorschiene
fantays	fantasy
seyfried,	seyfried
zwillingfrau	zwillingsfrau
citirizin	cetirizin
mietsoiegel	mietspiegel
aljazeera.tv	aljazeera.net
wohnugnen	wohnungen
ronaldos	ronaldo
speichelsteine	speichelstein
cat®	cat
bronchitis,	bronchitis
italienier	italiener
hendekte	hendek
datenbaltt	datenblatt
cuaght	caught
grimmrock	grimrock
malik's	malik
schwarzhufe	schwarzhuf
şifresi	sifresi
embarzo	embarazo
johanson	johansson
www.babie	www.barbie
nackenfaltemessung	nackenfaltenmessung
genitialbereich	genitalbereich
son.dakika	sondakika
converter,	converter
jassica	jessica
neesons	neeson
croûte	croute
chronicen	chroniken
lmmobilien	immobilien
moeblierte	möblierte
honor:	honor
gossip,	gossip
blaster,	blaster
telcinco	telecinco
horoscopio	horoscopo
antibitika	antibiotika
kangoo,	kangoo
hpeprint	eprint
kürbisuppe	kürbissuppe
inserien	inserieren
editting	editing
débrideur	debrideur
boğazdan	bogazdan
deinstallierbar	deinstallieren
druchfall	durchfall
anglina	angelina
hsberleri	haberleri
contorsionist	contortionist
plantars	plantar
bauchscherzen	bauchschmerzen
vanssa	vanessa
antibiotikum	antibiotika
riberys	ribery
eignetumswohnung	eigentumswohnung
läschen	löschen
raspberri	raspberry
naechtliches	nächtliches
orgamus	orgasmus
pokèmon	pokemon
schener	schöner
fesstos	festos
fressattaken	fressattacken
oeffentlichkeit	öffentlichkeit
crusible	crucible
kattarina	katarina
eigentumswohnungne	eigentumswohnung
narutop	naruto
freunde2	freunde
stratholm	stratholme
gofenimin	gofeminin
15wochen	wochen
granden	grande
eqestria	equestria
niggers	niggas
honor™	honor:
eigentumswohnunf	eigentumswohnung
peopleen	people
bleching	bleaching
toepfchen	töpfchen
posession	possession
zunhemen	zunehmen
abstzen	absetzen
rrriyet	rriyet
erricson	ericsson
weihnachtskeks	weihnachtskekse
körnigen	körniger
amanada	amanda
herzgold	heartgold
abtreibt	abtreiben
will.i.am.	will.i.am
vkontkte.ru	kontakt.ru
synonms	synonym
invinite	infinite
goettliche	göttliche
galataray	galatasaray
eigentumswohung	eigentumswohnung
transmogg	transmog
warhol's	warhol
bltung	blutung
salzfleck	salzflecken
leagure	league
scheckt	schmeckt
warrioir	warrior
geeforce	geforce
eientumswohnung	eigentumswohnung
portakallı	portakalli
wohnunge	wohnung
melenzane	melanzane
24.com.vn	24h.com.vn
schmieblutung	schmierblutung
corrier	corriere
seltsam,	seltsam
yughioh	yugioh
uberruhr	überruhr
songrext	songtext
black's	blacks
superiorpic	superiorpics
moberfire	mobafire
mediadet	mediaset
tarraria	terraria
mivhael	michael
wohnungeb	wohnung
rissigen	rissige
iphote	iphoto
casiragi	casiraghi
reichweiter	reichweite
ruyada	rüyada
aquarious	aquarius
tactics:	tactics
ratskeller,	ratskeller
optimzer	optimizer
synomyms	synonym
odity	oddity
malyala	malayala
llittle	little
i9mmobilien	immobilien
osterfelt	osterfeld
eohnungen	wohnungen
aussergewöhnlichen	außergewöhnlichen
kekelli	kekilli
immnobilien	immobilien
bezeihung	beziehung
songteyt	songtext
tiramis	tiramisu
Öztunali	öztunali
hürremi	hürrem
kingdome	kingdom
rezeote	rezepte
ballacks	ballack
stimuliren	stimulieren
hilson)	hilson
gngnam	gangnam
zeitgesteuertes	zeitgesteuert
lakeien	lakaien
donwloader	downloader
bkaufen	kaufen
zen:	zen
www.barbie.	www.barbie
horroscopo	horoscopo
forreign	foreign
blondiren	blondieren
freundins	freundin
you`ve	you've
liyrics	lyrics
pokenon	pokemon
supernaturl	supernatural
acrobar	acrobat
restaaurant	restaurant
bewerbungsphotos	bewerbungsfotos
3.handball	handball
zahnendem	zahnendes
upton's	upton
smartys	smarty
readsnow	redsn0w
quedarte	quedar
antibiothikum	antibiotika
bullocks	bullock
fibrator	vibrator
verschluesseln	verschlüsseln
pronoseiten	pornoseiten
sinsister	sinister
partizion	partition
oflegends	legends
bilbord	billboard
devil´s	devil's
kaqufen	kaufen
colchikum	colchicum
11wochen	wochen
kaloriebedarf	kalorienbedarf
schlücken	schlucken
lkaufen	kaufen
yozr	your
panasoniv	panasonic
kurzhaarschitte	kurzhaarschnitte
wihelmsburg	wilhelmsburg
teleicnco	telecinco
billborad	billboard
ue40es6300s	ue40es6300
summertine	summertime
manager14	manager
hortensienkränze	hortensienkranz
michellin	michelin
chookdee	chokdee
dylan:	dylan
schmierbluten	schmierblutung
nnaruto	naruto
derincede	derince
wettervorhersgae	wettervorhersage
screenshort	screenshot
hamuruyla	hamurundan
wohnuhng	wohnung
eatser	easter
booble	bubble
griffendor	gryffindor
synonymns	synonym
buscupan	buscopan
berzek	berzerk
lyriics	lyrics
hochsteckfriseuren	hochsteckfrisuren
lyrixcs	lyrics
synonmys	synonym
stähnen	strähnen
telecinoc	telecinco
draginball	dragonball
rueters	reuters
aufgehort	aufgehört
www.galaxi	www.galaxy
sondertilgungen	sondertilgung
nightinggale	nightingale
gougère	gougères
chalres	charles
7service	service
guneyin	güneyin
meteo.	meteo
haesslichsten	hässlichsten
wohngung	wohnung
ınternet	internet
symptpme	symptome
ismaıl	ismail
infinit	infinite
neuseelnad	neuseeland
köstenlose	kostenlose
digomon	digimon
umkaloabo	umckaloabo
fitnessübung	fitnessübungen
kompromieren	komprimieren
squierten	squirten
vergewltigt	vergewaltigt
throned	thrones
sped.io	speed.io
pickelmal	pickelmale
electras	electra
schperma	sperma
blooomberg	bloomberg
phrophet	prophet
7wochen	wochen
shakespare	shakespeare
iregular	irregular
hathway	hathaway
alexandrias	alexandria
nicklodion	nickelodeon
wohungne	wohnung
ordanary	ordinary
carfting	crafting
symptomr	symptome
fußzeilen	fußzeile
nebenwirkunen	nebenwirkungen
körbchengrösse	körbchengröße
elverts	elvers
withaout	without
parises	parrises
longst	longest
saminas	samina
presidental	presidential
dispicable	despicable
steart	stewart
preganacy	pregnancy
yangınlar	yanginlar
speech:	speech
verdunstungslinien	verdunstungslinie
intenret	internet
donnerwettr	donnerwetter
cinammon	cinnamon
wasserlasen	wasserlassen
hammerstein's	hammerstein
harrenhall	harrenhal
deckerts	deckert
sajajin	saiyajin
andeoid	android
magenschleimhautentzundung	magenschleimhautentzündung
weichere	weiche
teptone	stepstone
schilddruesentabletten	schilddrüsentabletten
ringfreier	ringfreie
hereoes	heroes
exhaustif	exhaustive
azaelia	azealia
perfecht	perfect
pickeln	pickel
warfight	warfighter
streep's	streep
geklaut,	geklaut
doppelclick	doppelklick
tropies	trophies
www.4arab.org	www.4arabz.org
inpossible	impossible
rıhanna	rihanna
juengeren	jüngeren
virtal	virtual
juwelenschleifer	juwelenschleifen
cricke	cricket
beutlins	beutlin
wochnung	wohnung
cratures	creatures
profre	profree
spears,	spears
closer,	closer
balcovada	balcova
dángelo	d'angelo
ennifer	jennifer
fruchtsaurepeeling	fruchtsäurepeeling
fantassy	fantasy
kauefn	kaufen
wirhout	without
telegrafi.	telegrafi
daioymotion	dailymotion
taylot	taylor
lyrircs	lyrics
melcken	melken
livelys	lively
versac	versace
baumgatner	baumgartner
naugty	naughty
guitrar	guitar
whonung	wohnung
drakensank	drakensang
aaliyah)	aaliyah
moetwohnung	mietwohnung
dailymotion:	dailymotion
echords	chords
craftign	crafting
stellug	stellung
immupret	imupret
fisget	fidget
podolskis	podolski
koyden	köyden
earps	earp's
akamaihd.net	a.akamaihd.net
sprerren	sperren
brautiful	beautiful
expolrer	explorer
buuble	bubble
kieten	mieten
litlle	little
wohnunegn	wohnungen
rationpharm	ratiopharm
buinen	buien
Übungswehen	übungswehen
kaufren	kaufen
babaren	barbaren
eigentmswohnung	eigentumswohnung
volontariate	volontariat
antibotika	antibiotika
12wochen	wochen
balkons	balkon's
ayvalikta	ayvalik
zuehen	ziehen
^wohnungen	wohnungen
schwammkof	schwammkopf
retsaurants	restaurant
pumpking	pumpkin
organini	organi
messter	meester
lesbiab	lesbian
kompabilitätsmodus	kompatibilitätsmodus
fllout	fallout
darstellet	darsteller
brandão	brandao
beuenradar	buienradar
arbitage	arbitrage
anicent	ancient
abfuehren	abführen
kontakti.ru	kontakt.ru
plötzlichen	plötzlicher
americna	american
gehirnerschutterung	gehirnerschütterung
frrisuren	frisuren
torschützenkönige	torschützenkönig
eliteskill	eliteskills
schülr	schüler
maraiah	mariah
mmovies	movies
eigentunmswohnung	eigentumswohnung
analtrombosen	analthrombose
shoooter	shooter
blazblue:	blazblue
enbarazo	embarazo
sehnenscheidenentzuendung	sehnenscheidenentzündung
getmany	germany
geraetemanager	gerätemanager
strahnchen	strähnchen
stewar	stewart
eredevisie	eredivisie
mincecraft	minecraft
slyrics	lyrics
arkkorde	akkorde
schüler.	schüler
grundtsücke	grundstücke
gamser	gemser
bellara	belara
upsite	upside
geplatzt,	geplatzt
unleashed2	unleashed
terazza	terrazza
projext	project
guaedian	guardian
schahmlippen	schamlippen
songetx	songtext
digitaly	digital
ovacikta	ovacik
whintey	whitney
reaksion	reaksiyon
sütlaç	sütlac
schuettelkuchen	schüttelkuchen
camissa	camisa
milchmaedchen	milchmädchen
huskauf	hauskauf
runnaway	runaway
gaht	gath
sokagı	sokagi
holbein's	holbeins
richardsons	richardson
nebenwrkungen	nebenwirkungen
l’autre	l'autre
loopers	looper
waxxenegger	waxenegger
digimom	digimon
stiched	stitched
patreus	petraeus
mccurd	mccurdy
glykämischen	glykämischer
glässchen	gläschen
wahrscheinlickeit	wahrscheinlichkeit
augebrauen	augenbrauen
ylyrics	lyrics
<immobilien	immobilien
filmstarrts	filmstarts
areosmith	aerosmith
o’gorman	o'gorman
traenendes	tränendes
sandé	sande
vibrucol	viburcol
lidschaten	lidschatten
zülpischer	zülpicher
maverrick	maverick
dishornerd	dishonored
warfarme	warframe
metacritiv	metacritic
horospoco	horoscopo
mietwohnugn	mietwohnung
whitout	without
scheidenentzundung	scheidenentzündung
haarverlaengerung	haarverlängerung
madeleine's	madeleine
heaven´s	heaven's
curruption	corruption
kurzharschnitte	kurzhaarschnitte
skyrim:	skyrim
reastaurant	restaurant
donnerwtter	donnerwetter
m`barek	m'barek
withou	without
darstelle	darsteller
massase	massage
alguiler	alquiler
nageloel	nagelöl
maedelsabend	mädelsabend
zelweger	zellweger
programaçao	programação
oyur	your
prmier	premier
govener	governor
recource	resource
zeitlosen	zeitlose
sympotme	symptome
monsters:	monsters
junkesdorf	junkersdorf
haskauf	hauskauf
enhaced	enhanced
bekommz	bekommt
lyricxs	lyrics
nigela	nigella
haberleir	haberleri
tifenbach	tiefenbach
ultrbook	ultrabook
leapard	leopard
bilities	bilitis
berengenas	berenjenas
perferct	perfect
wr1043	wr1043nd
muh,	muh
cagtay	cagatay
schlaag	schlag
willaims	williams
gwynneth	gwyneth
beypnce	beyonce
kürbissuppen	kürbissuppe
astroloj	astroloji
fastmm4	fastmm
prfect	perfect
truhenschlüssel]	truhenschlüssel
hikmetin	hikmet
eseltritt	eselstritt
champman	chapman
sensatio	sensation
juliet,	juliet
makellosen	makelloser
downgrad	downgrade
moppelige	mollige
anarchy:	anarchy
aldıran	aldiran
knopfler,	knopfler
prostataentzuendung	prostataentzündung
pokasivaem	pokazyvaem
creed®	creed
ritney	britney
kah´tir	kah'tir
eltergeld	elterngeld
sschwangerschaft	schwangerschaft
mucveri	mücveri
zwiebelsuppen	zwiebelsuppe
pettings	petting
incesuda	incesu
synonym,	synonym
betreues	betreutes
kigdom	kingdom
moskavanin	moskovanin
diamods	diamonds
aderson	anderson
promethues	prometheus
verschnittoptimierung	zuschnittoptimierung
midyatta	midyat
erfolgreisten	erfolgreichsten
adeventure	adventure
quizzduell	quizduell
hochzahl	hochzahlen
selbstbräunung	selbstbräuner
meringuee	meringuée
kalsın	kalsin
regelschmerzen,	regelschmerzen
bochumn	bochum
bakuras	bakura
kurnikowa	kournikova
awkwards	awkward
addictet	addicted
cheescake	cheesecake
achwangerschaft	schwangerschaft
restraurant	restaurant
cebrity	celebrity
butterkrem	buttercreme
goodgamer	goodgame
bale's	bale
amalur:	amalur
wahsington	washington
xspecial	xpecial
asymetrischen	asymmetrische
zepplin	zeppelin
vampie	vampire
grafikkaten	grafikkarten
oimmobilien	immobilien
kostenloise	kostenlos
exlorer	explorer
^twitch	twitch
friseut	friseur
veličanstveni	velicanstveni
huryet	hurriyet
vijaykarnataka	vijayakarnataka
skyrimm	skyrim
minecrafe	minecraft
dwarfen	dwarven
arschlock	arschloch
antiandrogener	antiandrogene
vermietn	vermieten
gespreitzten	gespreizten
jungste	jüngste
plushd8	plushd.8
oztarhan	öztarhan
formuline	formoline
schilddruesenkrebs	schilddrüsenkrebs
poitiv	positiv
lavinge	lavigne
kuemmert	kümmert
avatat	avatar
mirrows	mirrors
kaptiel	kapitel
theives	thieves
lieghts	lights
pofn	porn
ornstars	pornstars
enttäuschungs	enttäuschung
enterokokkus	enterococcus
brookyln	brooklyn
filmstats	filmstarts
lyrikcs	lyrics
prednisilon	prednisolon
hungergefuehl	hungergefühl
vertex3	vertex
skyeim	skyrim
zuckung	zucken
playbpy	playboy
l'entrecôte	l'entrecote
marushka	maruschka
stellunge	stellungen
leahue	league
tristina	tristana
tiefliegender	tiefliegende
sphanx	sphax
wohnumgen	wohnungen
median,	median
thiecke	thicke
spriale	spirale
sonhtext	songtext
jones's	jones
mkieten	mieten
mobbafire	mobafire
brwoser	browser
freundin,	freundin
wohnungem	wohnung
immposible	impossible
entzuendete	entzündete
gebärmutter,	gebärmutter
fruehschwangerschaft	frühschwangerschaft
guiatr	guitar
novatv	nova
cochita	conchita
tagesspiel	tagesspiegel
galatasaraj	galatasaray
bleistiftstühle	bleistiftstuhl
oznaja	ochnaya
freidrichshain	friedrichshain
erostische	erotische
soll's	solls
peagant	pageant
amteuer	amateur
leoprad	leopard
guitra	guitar
schwangershaft	schwangerschaft
löschne	löschen
şampiyonlar	sampiyonlar
rtv.es	rtve.es
seasame	sesame
mirten	mieten
ergasmus	orgasmus
niggaz	niggas
recomendación	recomendacion
galaxiy	galaxy
discorvery	discovery
shampos	shampoo
feine,	feines
mobefire	mobafire
2sezona	sezona
posisiones	posiciones
wetteronline.	wetteronline
obadan	odaban
wphnungen	wohnungen
venlavaxin	venlafaxin
sschmerzen	schmerzen
schreit,	schreit
moieten	mieten
mogolisches	mongolisches
lesiban	lesbian
grasblöcke	grasblock
epilierte	epilieren
ebenwirkungen	nebenwirkungen
chanpions	champions
hawk's	hawk
sayibinden	sahibinden
eurosports	eurosport
restauranz	restaurant
undergorund	underground
sinnermann	sinnerman
modloade	modloader
battlestations:	battlestations
mananas	mañanas
charivarie	charivari
cain,	cain
autónomas	autonomas
televiziq	televizia
scöneberg	schöneberg
gissip	gossip
mietwohning	mietwohnung
schänze	schwänze
gleichunge	gleichungen
kuzhaarfrisur	kurzhaarfrisur
televizive	televizionet
reitstellung	reiterstellung
jungfernheutchen	jungfernhäutchen
donnewetter	donnerwetter
zezepte	rezepte
bachbluten	bachblüten
današnji	danasnji
monoril	monuril
veressen	vergessen
bokini	bikini
steissbeinschmerzen	steißbeinschmerzen
kauden	kaufen
jilian	jillian
channel.	channel
satlık	satilik
bjørg	björg
wohnngen	wohnungen
schammlippen	schamlippen
varrus	varus
nebenwirkngen	nebenwirkungen
arcobat	acrobat
immobiloien	immobilien
triunf	triumf
awkard	awkward
stehlungen	stellungen
metacritc	metacritic
maveriks	mavericks
drachenfalken	drachenfalke
ansteckbar	ansteckend
guzelligin	güzelligin
ananym	anonym
ratipharm	ratiopharm
kabayeva	kabaeva
schoenheits	schönheits
pessanger	passenger
altaylı	altayli
passowrd	password
sparatcus	spartacus
macromastasia	macromastia
wetteronine	wetteronline
bodylotions	bodylotion
lauferk	laufwerk
genommen,	genommen
brasilan	brazilian
dolphin's	dolphins
wapitis	wapiti
haevens	heavens
besren	besten
itlian	italian
antiviren	antivirus
woppers	whoppers
smyptome	symptome
changed!	changed
skyrin	skyrim
abnehen	abnehmen
pozycie	pozycje
legends:	legends
einstei	einstein
sichelfüsse	sichelfuss
hatipoğlu'nun	hatipoglunun
erkannt,	erkannt
magazinde	magazin
rotbauchmandarine	rotbauchmandarin
posities	position
homeland,	homeland
frsiuren	frisuren
chansaw	chainsaw
starway	stairway
martials	martial
weissfluss	weißfluss
scarled	scarlet
hirnblutungen	hirnblutung
beschliesst	beschließt
pooren	poren
visula	visual
torrnet.com	torent.com
oringins	origins
teathering	tethering
possition	position
passenger,	passenger
leagens	legends
bujenradar	buienradar
qosimo	qosmio
eiweissshake	eiweißshake
massionette	maisonette
hochsteckfirsuren	hochsteckfrisuren
zunehmen,	zunehmen
maturer	mature
buchenpilze	buchenpilz
intressant	interessant
tepeörende	tepeören
kurzhaarfirsuren	kurzhaarfrisuren
adelklause	adelsklause
pickek	pickel
menéame	meneame
scharmbereich	schambereich
pronstar	pornstar
seidener	seidenen
arsenel	arsenal
schulmädche	schulmädchen
unterbauch,	unterbauch
stirnfalte	stirnfalten
monecraft	minecraft
scorpionmann	skorpionmann
fruendin	freundin
expiria	xperia
wohnunug	wohnung
pupsglobulis	pupsglobuli
wohnungn	wohnung
alchimistenstein	alchemistenstein
hevens	heavens
fruechen	frühchen
carlifonication	californication
kaufebn	kaufen
ibuprufen	ibuprofen
abrechenbare	anrechenbare
pölchaukamp	poelchaukamp
couldn´t	couldn't
kurtköyde	kurtköy
sitomas	sintomas
downbouse	downblouse
hänsen	hänschen
gladiators]	gladiators
lenove	lenovo
telegraoh	telegraph
marriable	marriage
guardiolas	guardiola
futheqd	futhead
drakenang	drakensang
pankakes	pancakes
desparation	desperation
selbstbefriediegung	selbstbefriedigung
readhead	redhead
koerperbehaarung	körperbehaarung
brueser	brüser
six:	six
weohnung	wohnung
menderesin	menderes
schmeruen	schmerzen
rriyetim	rriyet
gnocchis	gnocchi
dunklere	dunkle
nùrnberg	nürnberg
oberschänkel	oberschenkel
ertses	erstes
digimin	digimon
freedome	freedom
umrißkarte	umrisskarte
sehsade	sehzade
